西安-西安-西安	碑林/未央/高新/莲湖/新城/雁塔
北京-北京-北京	朝阳/海淀/昌平/丰台/大兴/燕郊
苏州-苏州-苏州	园区/新区/吴中/昆山/吴江/沧浪
南京-南京-南京	浦口/江宁/六合/鼓楼/白下/玄武
成都-成都-成都	青羊/武侯/其他/双流/金牛/锦江
长春-长春-长春	宽城/南关/绿园/朝阳/二道/经开
大连-大连-大连	甘井子/开发区/沙河口/金州/中山/旅顺口
沈阳-沈阳-沈阳	铁西/大东/皇姑/于洪/和平/沈河
广州-广州-广州	番禺/天河/海珠/白云/越秀/南沙
深圳-深圳-深圳	宝安/龙岗/福田/罗湖/南山/盐田
重庆-重庆-重庆	渝北/南岸/九龙坡/江北/其他市县/渝中
上海-上海-上海	闵行/浦东/宝山/徐汇/松江/嘉定
武汉-武汉-武汉	武昌/洪山/江岸/东西湖/江汉/汉阳
杭州-杭州-杭州	西湖/滨江/余杭/江干/拱墅/上城
天津-天津-天津	塘沽/河东/南开/河西/河北/大港
西安-蓝田-蓝田	临潼/阎良/灞桥/高陵县/哄/新城
西安-长安-长安	雁塔/碑林/曲江新区/莲湖/高新/未央
西安-灞桥-灞桥	哄/新城/高陵县/曲江新区/碑林/长安
西安-临潼-临潼	阎良/蓝田/高陵县/灞桥/哄/新城
西安-沣渭新区-沣渭新区	户县/高新/莲湖/未央/雁塔/长安
西安-高陵县-高陵县	灞桥/哄/新城/临潼/阎良/曲江新区
西安-雁塔-雁塔	碑林/长安/莲湖/曲江新区/高新/未央
西安-新城-新城	哄/曲江新区/灞桥/碑林/长安/雁塔
西安-未央-未央	莲湖/高新/雁塔/碑林/曲江新区/长安
西安-碑林-碑林	曲江新区/雁塔/长安/未央/莲湖/新城
西安-阎良-阎良	临潼/高陵县/蓝田/灞桥/哄/新城
西安-曲江新区-曲江新区	碑林/长安/雁塔/新城/未央/哄
西安-高新-高新	莲湖/雁塔/未央/长安/碑林/曲江新区
西安-哄-哄	新城/灞桥/曲江新区/碑林/高陵县/长安
西安-户县-户县	沣渭新区/高新/莲湖/未央/雁塔/长安
西安-莲湖-莲湖	高新/未央/雁塔/碑林/长安/曲江新区
西安-周至县-周至县	户县/沣渭新区/高新/莲湖/未央/雁塔
北京-密云-密云	北京周边/燕郊/怀柔/顺义/通州/平谷
北京-石景山-石景山	丰台/房山/门头沟/海淀/昌平/宣武
北京-通州-通州	顺义/北京周边/燕郊/怀柔/朝阳/崇文
北京-房山-房山	石景山/门头沟/丰台/海淀/大兴/宣武
北京-顺义-顺义	怀柔/通州/北京周边/燕郊/密云/朝阳
北京-昌平-昌平	石景山/海淀/丰台/门头沟/西城/宣武
北京-丰台-丰台	海淀/宣武/大兴/西城/石景山/东城
北京-宣武-宣武	西城/海淀/大兴/丰台/东城/崇文
北京-怀柔-怀柔	顺义/通州/密云/北京周边/燕郊/朝阳
北京-平谷-平谷	密云/北京周边/燕郊/顺义/通州/怀柔
北京-海淀-海淀	丰台/宣武/西城/大兴/石景山/东城
北京-西城-西城	宣武/东城/海淀/崇文/朝阳/丰台
北京-燕郊-燕郊	北京周边/通州/顺义/密云/怀柔/平谷
北京-朝阳-朝阳	崇文/东城/西城/宣武/大兴/海淀
北京-大兴-大兴	宣武/丰台/西城/海淀/东城/崇文
北京-门头沟-门头沟	房山/石景山/昌平/丰台/海淀/大兴
北京-东城-东城	崇文/朝阳/西城/宣武/海淀/大兴
北京-崇文-崇文	朝阳/东城/西城/宣武/大兴/海淀
北京-延庆-延庆	门头沟/昌平/石景山/房山/海淀/丰台
北京-北京周边-北京周边	燕郊/通州/顺义/密云/怀柔/平谷
苏州-张家港-张家港	常熟/相城/园区/平江/金阊/沧浪
苏州-常熟-常熟	张家港/昆山/相城/园区/平江/沧浪
苏州-沧浪-沧浪	平江/吴中/金阊/相城/园区/吴江市
苏州-昆山-昆山	常熟/太仓/园区/相城/吴江市/吴中
苏州-太仓-太仓	昆山/常熟/园区/相城/张家港/沧浪
苏州-吴江市-吴江市	吴中/沧浪/平江/园区/金阊/相城
苏州-园区-园区	相城/沧浪/平江/吴中/金阊/吴江市
苏州-金阊-金阊	平江/沧浪/吴中/相城/园区/新区
苏州-平江-平江	沧浪/吴中/金阊/相城/园区/吴江市
苏州-新区-新区	金阊/吴中/平江/沧浪/相城/吴江市
苏州-吴中-吴中	沧浪/平江/金阊/园区/吴江市/相城
苏州-相城-相城	平江/沧浪/园区/金阊/吴中/吴江市
南京-下关-下关	鼓楼/秦淮/大厂/白下/建邺/玄武
南京-秦淮-秦淮	白下/玄武/下关/鼓楼/江宁/建邺
南京-江宁-江宁	秦淮/白下/玄武/鼓楼/雨花台/下关
南京-浦口-浦口	雨花台/建邺/鼓楼/大厂/下关/秦淮
南京-白下-白下	秦淮/玄武/下关/江宁/鼓楼/建邺
南京-高淳-高淳	溧水/江宁/白下/秦淮/玄武/栖霞
南京-六合-六合	大厂/下关/玄武/鼓楼/白下/秦淮
南京-玄武-玄武	白下/秦淮/下关/鼓楼/江宁/大厂
南京-建邺-建邺	鼓楼/雨花台/下关/秦淮/大厂/白下
南京-鼓楼-鼓楼	下关/建邺/秦淮/白下/大厂/雨花台
南京-栖霞-栖霞	玄武/白下/秦淮/六合/下关/溧水
南京-大厂-大厂	下关/鼓楼/建邺/六合/秦淮/白下
南京-雨花台-雨花台	建邺/鼓楼/下关/江宁/秦淮/白下
南京-溧水-溧水	高淳/栖霞/江宁/玄武/白下/秦淮
成都-大邑-大邑	邛崃/蒲江/崇州/都江堰/新津/温江
成都-郫县-郫县	高新西区/温江/彭州/新津/武侯/金牛
成都-温江-温江	郫县/新津/高新西区/彭州/武侯/双流
成都-彭州-彭州	郫县/高新西区/温江/金牛/武侯/青羊
成都-金牛-金牛	青羊/武侯/国家高新技术产业开发区/锦江/双流/成华
成都-金堂-金堂	龙泉驿/青白江/新都/成华/锦江/国家高新技术产业开发区
成都-青白江-青白江	龙泉驿/新都/成华/锦江/青羊/国家高新技术产业开发区
成都-双流-双流	武侯/国家高新技术产业开发区/金牛/青羊/锦江/成华
成都-成华-成华	锦江/青羊/国家高新技术产业开发区/新都/金牛/武侯
成都-锦江-锦江	青羊/国家高新技术产业开发区/成华/金牛/武侯/双流
成都-都江堰-都江堰	崇州/大邑/蒲江/温江/邛崃/新津
成都-国家高新技术产业开发区-国家高新技术产业开发区	青羊/锦江/武侯/金牛/双流/成华
成都-新津-新津	温江/郫县/高新西区/彭州/双流/崇州
成都-新都-新都	成华/锦江/青羊/青白江/国家高新技术产业开发区/金牛
成都-高新西区-高新西区	郫县/温江/彭州/武侯/新津/金牛
成都-武侯-武侯	金牛/青羊/国家高新技术产业开发区/双流/锦江/成华
成都-龙泉驿-龙泉驿	青白江/新都/成华/锦江/国家高新技术产业开发区/青羊
成都-青羊-青羊	国家高新技术产业开发区/金牛/锦江/武侯/成华/双流
成都-崇州-崇州	都江堰/蒲江/大邑/邛崃/温江/新津
成都-邛崃-邛崃	大邑/蒲江/崇州/都江堰/新津/温江
成都-蒲江-蒲江	邛崃/大邑/崇州/都江堰/新津/温江
长春-经开-经开	二道区/南关区/宽城区/净月/朝阳区/汽车城
长春-净月-净月	二道区/经开/南关区/宽城区/朝阳区/汽车城
长春-高新-高新	朝阳区/汽车城/绿园区/宽城区/南关区/经开
长春-农安县-农安县	绿园区/汽车城/宽城区/高新/朝阳区/南关区
长春-九台市-九台市	德惠市/双阳区/净月/二道区/经开/南关区
长春-榆树市-榆树市	九台市/德惠市/双阳区/净月/二道区/经开
长春-南关区-南关区	经开/二道区/宽城区/朝阳区/汽车城/净月
长春-二道区-二道区	经开/南关区/宽城区/净月/朝阳区/汽车城
长春-德惠市-德惠市	九台市/净月/二道区/经开/农安县/南关区
长春-绿园区-绿园区	汽车城/高新/朝阳区/宽城区/南关区/经开
长春-宽城区-宽城区	南关区/经开/二道区/朝阳区/汽车城/绿园区
长春-双阳区-双阳区	净月/二道区/经开/南关区/宽城区/朝阳区
长春-汽车城-汽车城	绿园区/朝阳区/高新/宽城区/南关区/经开
长春-朝阳区-朝阳区	汽车城/高新/绿园区/宽城区/南关区/经开
大连-瓦房店市-瓦房店市	金州区/开发区/中山区/甘井子区/西岗区/高新园区
大连-沙河口区-沙河口区	高新园区/甘井子区/西岗区/中山区/金州区/开发区
大连-长海县-长海县	普兰店市/庄河市/开发区/金州区/瓦房店市/中山区
大连-普兰店市-普兰店市	长海县/瓦房店市/开发区/金州区/中山区/西岗区
大连-旅顺口区-旅顺口区	沙河口区/甘井子区/高新园区/西岗区/中山区/金州区
大连-中山区-中山区	西岗区/高新园区/甘井子区/沙河口区/金州区/开发区
大连-开发区-开发区	金州区/中山区/西岗区/高新园区/甘井子区/沙河口区
大连-庄河市-庄河市	长海县/普兰店市/瓦房店市/开发区/金州区/中山区
大连-高新园区-高新园区	沙河口区/甘井子区/西岗区/中山区/金州区/开发区
大连-甘井子区-甘井子区	沙河口区/高新园区/西岗区/中山区/金州区/开发区
大连-西岗区-西岗区	高新园区/中山区/甘井子区/沙河口区/金州区/开发区
大连-金州区-金州区	开发区/中山区/西岗区/高新园区/甘井子区/沙河口区
沈阳-浑南新区-浑南新区	东陵区/沈河区/大东区/和平区/皇姑区/铁西区
沈阳-和平区-和平区	皇姑区/铁西区/沈河区/东陵区/浑南新区/大东区
沈阳-大东区-大东区	沈河区/东陵区/皇姑区/浑南新区/和平区/铁西区
沈阳-苏家屯区-苏家屯区	于洪区/铁西区/和平区/皇姑区/浑南新区/东陵区
沈阳-铁西区-铁西区	和平区/皇姑区/于洪区/沈河区/苏家屯区/东陵区
沈阳-法库县-法库县	康平县/沈北新区/皇姑区/铁西区/大东区/沈河区
沈阳-康平县-康平县	法库县/沈北新区/皇姑区/铁西区/于洪区/大东区
沈阳-新民市-新民市	辽中县/于洪区/苏家屯区/铁西区/和平区/皇姑区
沈阳-沈河区-沈河区	大东区/东陵区/皇姑区/浑南新区/和平区/铁西区
沈阳-沈北新区-沈北新区	大东区/沈河区/皇姑区/东陵区/和平区/浑南新区
沈阳-辽中县-辽中县	新民市/于洪区/苏家屯区/铁西区/和平区/皇姑区
沈阳-于洪区-于洪区	铁西区/苏家屯区/和平区/皇姑区/沈河区/浑南新区
沈阳-皇姑区-皇姑区	和平区/沈河区/大东区/东陵区/铁西区/浑南新区
沈阳-东陵区-东陵区	沈河区/大东区/浑南新区/皇姑区/和平区/铁西区
广州-白云-白云	越秀/海珠/荔湾/天河/花都/番禺
广州-番禺-番禺	天河/黄埔/海珠/白云/越秀/萝岗
广州-增城-增城	从化/经济开发区/南沙/萝岗/黄埔/番禺
广州-从化-从化	经济开发区/萝岗/黄埔/增城/天河/南沙
广州-经济开发区-经济开发区	萝岗/黄埔/南沙/番禺/从化/天河
广州-花都-花都	荔湾/白云/越秀/海珠/天河/番禺
广州-天河-天河	白云/番禺/海珠/越秀/荔湾/黄埔
广州-越秀-越秀	海珠/荔湾/白云/天河/花都/番禺
广州-南沙-南沙	萝岗/经济开发区/黄埔/番禺/天河/从化
广州-萝岗-萝岗	经济开发区/黄埔/南沙/番禺/天河/从化
广州-荔湾-荔湾	越秀/海珠/白云/花都/天河/番禺
广州-海珠-海珠	越秀/白云/荔湾/天河/花都/番禺
广州-黄埔-黄埔	萝岗/经济开发区/番禺/天河/南沙/白云
深圳-龙岗-龙岗	盐田/坪山新区/罗湖/福田/光明新区/南山
深圳-光明新区-光明新区	宝安/南山/福田/罗湖/盐田/龙岗
深圳-罗湖-罗湖	福田/盐田/龙岗/南山/坪山新区/光明新区
深圳-福田-福田	罗湖/南山/宝安/光明新区/盐田/龙岗
深圳-坪山新区-坪山新区	龙岗/盐田/罗湖/福田/光明新区/南山
深圳-南山-南山	宝安/光明新区/福田/罗湖/盐田/龙岗
深圳-盐田-盐田	龙岗/罗湖/坪山新区/福田/南山/光明新区
深圳-宝安-宝安	南山/光明新区/福田/罗湖/盐田/龙岗
重庆-大足县-大足县	双桥区/荣昌县/潼南县/永川区/铜梁县/璧山县
重庆-南岸区-南岸区	渝中区/江北区/两江新区/九龙坡区/万州区/巴南区
重庆-巫山县-巫山县	巫溪县/奉节县/云阳县/黔江区/秀山土家族苗族自治县/城口县
重庆-巴南区-巴南区	九龙坡区/大渡口区/江北区/南岸区/渝中区/万州区
重庆-武隆县-武隆县	丰都县/涪陵区/忠县/彭水苗族土家族自治县/石柱土家族自治县/梁平县
重庆-城口县-城口县	云阳县/开县/黔江区/忠县/石柱土家族自治县/奉节县
重庆-涪陵区-涪陵区	垫江县/长寿区/南川区/丰都县/武隆县/梁平县
重庆-长寿区-长寿区	南川区/万盛区/垫江县/涪陵区/渝北区/綦江县
重庆-沙坪坝区-沙坪坝区	大渡口区/九龙坡区/万州区/江北区/巴南区/两江新区
重庆-璧山县-璧山县	江津区/合川区/北碚区/铜梁县/沙坪坝区/大渡口区
重庆-万州区-万州区	江北区/九龙坡区/两江新区/渝中区/大渡口区/南岸区
重庆-云阳县-云阳县	开县/城口县/黔江区/石柱土家族自治县/酉阳土家族苗族自治县/忠县
重庆-秀山土家族苗族自治县-秀山土家族苗族自治县	酉阳土家族苗族自治县/黔江区/云阳县/彭水苗族土家族自治县/奉节县/石柱土家族自治县
重庆-黔江区-黔江区	酉阳土家族苗族自治县/秀山土家族苗族自治县/云阳县/彭水苗族土家族自治县/开县/石柱土家族自治县
重庆-渝中区-渝中区	南岸区/江北区/两江新区/万州区/九龙坡区/巴南区
重庆-永川区-永川区	双桥区/铜梁县/大足县/潼南县/璧山县/荣昌县
重庆-潼南县-潼南县	大足县/双桥区/铜梁县/永川区/荣昌县/璧山县
重庆-大渡口区-大渡口区	九龙坡区/沙坪坝区/万州区/巴南区/江北区/渝中区
重庆-开县-开县	云阳县/城口县/忠县/石柱土家族自治县/梁平县/彭水苗族土家族自治县
重庆-彭水苗族土家族自治县-彭水苗族土家族自治县	石柱土家族自治县/忠县/武隆县/丰都县/梁平县/酉阳土家族苗族自治县
重庆-铜梁县-铜梁县	璧山县/永川区/合川区/潼南县/江津区/双桥区
重庆-巫溪县-巫溪县	奉节县/巫山县/云阳县/城口县/黔江区/秀山土家族苗族自治县
重庆-忠县-忠县	石柱土家族自治县/梁平县/丰都县/彭水苗族土家族自治县/武隆县/开县
重庆-九龙坡区-九龙坡区	万州区/江北区/大渡口区/巴南区/渝中区/南岸区
重庆-江北区-江北区	万州区/渝中区/两江新区/九龙坡区/南岸区/巴南区
重庆-垫江县-垫江县	涪陵区/长寿区/丰都县/南川区/梁平县/武隆县
重庆-两江新区-两江新区	江北区/渝中区/万州区/南岸区/九龙坡区/大渡口区
重庆-合川区-合川区	璧山县/北碚区/江津区/沙坪坝区/铜梁县/大渡口区
重庆-荣昌县-荣昌县	大足县/双桥区/潼南县/永川区/铜梁县/璧山县
重庆-渝北区-渝北区	两江新区/南岸区/渝中区/江北区/万州区/九龙坡区
重庆-石柱土家族自治县-石柱土家族自治县	忠县/彭水苗族土家族自治县/梁平县/丰都县/武隆县/开县
重庆-酉阳土家族苗族自治县-酉阳土家族苗族自治县	黔江区/秀山土家族苗族自治县/彭水苗族土家族自治县/云阳县/石柱土家族自治县/开县
重庆-江津区-江津区	璧山县/合川区/北碚区/沙坪坝区/大渡口区/铜梁县
重庆-万盛区-万盛区	南川区/綦江县/长寿区/渝北区/南岸区/渝中区
重庆-北碚区-北碚区	沙坪坝区/大渡口区/合川区/万州区/九龙坡区/江北区
重庆-南川区-南川区	万盛区/长寿区/涪陵区/垫江县/綦江县/渝北区
重庆-奉节县-奉节县	巫溪县/巫山县/云阳县/黔江区/城口县/秀山土家族苗族自治县
重庆-丰都县-丰都县	武隆县/梁平县/忠县/涪陵区/石柱土家族自治县/垫江县
重庆-双桥区-双桥区	大足县/永川区/荣昌县/潼南县/铜梁县/璧山县
重庆-梁平县-梁平县	丰都县/忠县/石柱土家族自治县/武隆县/垫江县/涪陵区
重庆-綦江县-綦江县	巴南区/南岸区/渝中区/九龙坡区/江北区/渝北区
上海-浦东-浦东	杨浦区/虹口区/黄浦区/卢湾区/闸北区/静安区
上海-黄浦区-黄浦区	卢湾区/闸北区/虹口区/静安区/杨浦区/徐汇区
上海-闵行区-闵行区	徐汇区/长宁区/普陀区/静安区/卢湾区/闸北区
上海-长宁区-长宁区	徐汇区/静安区/普陀区/闸北区/卢湾区/黄浦区
上海-杨浦区-杨浦区	虹口区/浦东/黄浦区/卢湾区/闸北区/静安区
上海-卢湾区-卢湾区	闸北区/黄浦区/静安区/徐汇区/长宁区/虹口区
上海-奉贤区-奉贤区	闵行区/徐汇区/卢湾区/金山区/黄浦区/静安区
上海-金山区-金山区	奉贤区/松江区/闵行区/徐汇区/长宁区/普陀区
上海-嘉定区-嘉定区	普陀区/长宁区/闵行区/松江区/崇明县/青浦区
上海-青浦区-青浦区	松江区/嘉定区/闵行区/普陀区/长宁区/金山区
上海-崇明县-崇明县	宝山区/嘉定区/普陀区/闸北区/长宁区/静安区
上海-宝山区-宝山区	虹口区/杨浦区/闸北区/黄浦区/卢湾区/静安区
上海-虹口区-虹口区	杨浦区/黄浦区/浦东/卢湾区/闸北区/静安区
上海-闸北区-闸北区	静安区/卢湾区/黄浦区/长宁区/徐汇区/虹口区
上海-静安区-静安区	闸北区/卢湾区/长宁区/徐汇区/黄浦区/普陀区
上海-南汇区-南汇区	浦东/杨浦区/虹口区/黄浦区/奉贤区/卢湾区
上海-徐汇区-徐汇区	长宁区/静安区/卢湾区/闸北区/普陀区/黄浦区
上海-普陀区-普陀区	长宁区/徐汇区/静安区/闸北区/卢湾区/闵行区
上海-松江区-松江区	青浦区/闵行区/嘉定区/金山区/普陀区/长宁区
武汉-~口-~口	东西湖/江汉/沌口开发区/汉阳/江岸/武昌
武汉-江汉-江汉	汉阳/江岸/武昌/~口/洪山/江夏
武汉-汉南-汉南	蔡甸/沌口开发区/东西湖/~口/汉阳/江汉
武汉-沌口开发区-沌口开发区	东西湖/~口/汉阳/江汉/蔡甸/江岸
武汉-江岸-江岸	江汉/汉阳/武昌/洪山/~口/青山
武汉-洪山-洪山	武昌/江夏/汉阳/青山/江岸/江汉
武汉-黄陂-黄陂	青山/江岸/武昌/江汉/洪山/汉阳
武汉-武昌-武昌	洪山/汉阳/江岸/江汉/青山/江夏
武汉-江夏-江夏	洪山/武昌/汉阳/江汉/江岸/青山
武汉-汉阳-汉阳	江汉/江岸/武昌/洪山/~口/江夏
武汉-新洲-新洲	青山/黄陂/洪山/武昌/江岸/江夏
武汉-青山-青山	洪山/武昌/江岸/黄陂/江汉/汉阳
武汉-蔡甸-蔡甸	东西湖/汉南/沌口开发区/~口/江汉/汉阳
武汉-东西湖-东西湖	沌口开发区/~口/蔡甸/江汉/汉阳/江岸
杭州-滨江-滨江	上城/下城/萧山/拱墅/西湖/江干
杭州-富阳-富阳	桐庐/余杭/西湖/滨江/拱墅/上城
杭州-余杭-余杭	西湖/拱墅/下城/上城/滨江/萧山
杭州-临安-临安	桐庐/建德/富阳/淳安/余杭/西湖
杭州-上城-上城	滨江/下城/拱墅/萧山/西湖/江干
杭州-江干-江干	萧山/下城/上城/滨江/拱墅/西湖
杭州-桐庐-桐庐	富阳/临安/建德/余杭/西湖/滨江
杭州-淳安-淳安	建德/临安/桐庐/富阳/余杭/西湖
杭州-拱墅-拱墅	下城/上城/滨江/西湖/萧山/余杭
杭州-下城-下城	拱墅/上城/滨江/萧山/西湖/江干
杭州-西湖-西湖	滨江/拱墅/余杭/上城/下城/萧山
杭州-建德-建德	桐庐/临安/淳安/富阳/余杭/西湖
杭州-萧山-萧山	滨江/上城/下城/江干/拱墅/西湖
天津-宁河县-宁河县	汉沽区/塘沽区/开发区/大港区/东丽区/津南区
天津-红桥区-红桥区	南开区/和平区/北辰区/河北区/河西区/河东区
天津-南开区-南开区	红桥区/和平区/河北区/北辰区/河西区/河东区
天津-河西区-河西区	河东区/和平区/河北区/南开区/红桥区/北辰区
天津-东丽区-东丽区	津南区/大港区/开发区/河东区/河西区/河北区
天津-西青区-西青区	静海县/武清区/南开区/红桥区/北辰区/和平区
天津-开发区-开发区	塘沽区/大港区/东丽区/津南区/汉沽区/河东区
天津-河北区-河北区	和平区/河西区/河东区/红桥区/北辰区/南开区
天津-河东区-河东区	河西区/河北区/和平区/红桥区/北辰区/南开区
天津-塘沽区-塘沽区	开发区/汉沽区/宁河县/大港区/东丽区/津南区
天津-宝坻区-宝坻区	蓟县/北辰区/河北区/河东区/东丽区/红桥区
天津-津南区-津南区	东丽区/大港区/河东区/河西区/开发区/河北区
天津-武清区-武清区	西青区/北辰区/红桥区/南开区/和平区/河北区
天津-汉沽区-汉沽区	宁河县/塘沽区/开发区/大港区/东丽区/津南区
天津-蓟县-蓟县	宝坻区/东丽区/北辰区/河北区/河东区/开发区
天津-和平区-和平区	河北区/河西区/红桥区/南开区/河东区/北辰区
天津-北辰区-北辰区	红桥区/河北区/和平区/南开区/河西区/河东区
天津-静海县-静海县	西青区/南开区/红桥区/武清区/和平区/北辰区
天津-大港区-大港区	津南区/开发区/东丽区/塘沽区/河东区/河西区
西安-蓝田-汤峪	焦岱/前卫/孟村/安村/城关/大寨
西安-蓝田-大寨	城关/安村/焦岱/前卫/孟村/汤峪
西安-蓝田-前卫	孟村/焦岱/汤峪/安村/城关/大寨
西安-蓝田-焦岱	安村/汤峪/前卫/孟村/城关/大寨
西安-蓝田-孟村	前卫/汤峪/焦岱/安村/城关/大寨
西安-蓝田-城关	大寨/安村/焦岱/前卫/孟村/汤峪
西安-蓝田-安村	焦岱/前卫/城关/孟村/大寨/汤峪
西安-长安-郭杜	子午/西京大学/滦镇/韦曲/长安区政府/王寺
西安-长安-西京大学	韦曲/长安区政府/子午/郭杜/太乙宫/滦镇
西安-长安-子午	西京大学/郭杜/韦曲/长安区政府/滦镇/太乙宫
西安-长安-引镇	太乙宫/长安区政府/韦曲/西京大学/子午/郭杜
西安-长安-王寺	斗门/滦镇/东大/郭杜/马王/子午
西安-长安-滦镇	东大/郭杜/王寺/斗门/子午/马王
西安-长安-斗门	马王/王寺/东大/滦镇/郭杜/子午
西安-长安-太乙宫	长安区政府/韦曲/西京大学/引镇/子午/郭杜
西安-长安-长安区政府	韦曲/西京大学/子午/郭杜/太乙宫/滦镇
西安-长安-韦曲	长安区政府/西京大学/子午/郭杜/太乙宫/滦镇
西安-长安-东大	滦镇/斗门/马王/王寺/郭杜/子午
西安-长安-马王	斗门/东大/王寺/滦镇/郭杜/子午
西安-临潼-行者	骊山/秦陵/新丰/斜口/代王
西安-临潼-新丰	秦陵/斜口/骊山/代王/行者
西安-临潼-斜口	新丰/代王/秦陵/骊山/行者
西安-临潼-代王	斜口/新丰/秦陵/骊山/行者
西安-临潼-骊山	行者/秦陵/新丰/斜口/代王
西安-临潼-秦陵	新丰/骊山/斜口/代王/行者
西安-雁塔-翠华路	国展中心/大雁塔/电视塔/长延堡/杨家村/小寨路
西安-雁塔-国展中心	长延堡/电视塔/杨家村/翠华路/小寨路/明德门
西安-雁塔-市政府小区	永松路/丁白路/吉祥路/太白小区/电子正街/北山门
西安-雁塔-电视塔	长延堡/杨家村/国展中心/小寨路/翠华路/鱼化寨
西安-雁塔-鱼化寨	明德门/吉祥路/小寨路/永松路/市政府小区/丁白路
西安-雁塔-等驾坡	西影路/大雁塔/翠华路/国展中心/电视塔/长延堡
西安-雁塔-电子正街	北山门/电子城/丁白路/太白小区/市政府小区/永松路
西安-雁塔-电子城	电子正街/北山门/太白小区/丁白路/太白南路/市政府小区
西安-雁塔-太白小区	丁白路/市政府小区/电子城/永松路/电子正街/北山门
西安-雁塔-小寨路	杨家村/电视塔/鱼化寨/长延堡/明德门/吉祥路
西安-雁塔-吉祥路	永松路/市政府小区/鱼化寨/丁白路/明德门/太白小区
西安-雁塔-大雁塔	翠华路/国展中心/电视塔/长延堡/杨家村/西影路
西安-雁塔-丁白路	市政府小区/太白小区/永松路/电子正街/北山门/电子城
西安-雁塔-长延堡	杨家村/电视塔/国展中心/小寨路/翠华路/明德门
西安-雁塔-明德门	鱼化寨/吉祥路/小寨路/永松路/市政府小区/杨家村
西安-雁塔-西影路	等驾坡/大雁塔/翠华路/国展中心/电视塔/长延堡
西安-雁塔-杨家村	长延堡/电视塔/国展中心/小寨路/明德门/鱼化寨
西安-雁塔-北山门	电子正街/电子城/丁白路/太白小区/市政府小区/永松路
西安-雁塔-永松路	市政府小区/丁白路/吉祥路/太白小区/电子正街/北山门
西安-雁塔-太白南路	电子城/太白小区/电子正街/北山门/丁白路/市政府小区
西安-新城-万寿路	韩森寨/长缨东路/长乐中路/建政街道/胡家庙/金花路
西安-新城-建政街道	金花路/长乐中路/韩森寨/互助路立交/长缨东路/胡家庙
西安-新城-西京医院	长乐西路/康复路/互助路立交/胡家庙/金花路/长乐中路
西安-新城-中山门	东五路/尚勤路/解放门/太华路/中山东路/新城街道
西安-新城-东五路	尚勤路/中山门/解放门/中山东路/太华路/新城街道
西安-新城-金花路	互助路立交/建政街道/长乐西路/长乐中路/胡家庙/西京医院
西安-新城-长乐中路	长缨东路/胡家庙/互助路立交/长乐西路/金花路/建政街道
西安-新城-互助路立交	长乐西路/金花路/胡家庙/西京医院/长乐中路/长缨东路
西安-新城-长缨东路	长乐中路/胡家庙/互助路立交/长乐西路/建政街道/韩森寨
西安-新城-西一路	西五路/文昌门/新城街道/中山东路/自强路/迎新路
西安-新城-人民路	迎新路/文昌门/西一路/西五路/自强路/新城街道
西安-新城-自强路	新城街道/解放门/中山东路/西五路/西一路/尚勤路
西安-新城-文昌门	西一路/西五路/新城街道/迎新路/中山东路/自强路
西安-新城-中山东路	新城街道/解放门/尚勤路/自强路/东五路/西五路
西安-新城-尚勤路	东五路/解放门/中山门/中山东路/新城街道/太华路
西安-新城-解放门	尚勤路/东五路/中山东路/新城街道/自强路/中山门
西安-新城-迎新路	西一路/西五路/文昌门/自强路/新城街道/中山东路
西安-新城-长乐西路	西京医院/互助路立交/胡家庙/长乐中路/金花路/康复路
西安-新城-康复路	西京医院/长乐西路/互助路立交/胡家庙/太华路/中山门
西安-新城-韩森寨	万寿路/建政街道/长缨东路/长乐中路/金花路/胡家庙
西安-新城-太华路	东五路/解放门/尚勤路/中山门/自强路/中山东路
西安-新城-西五路	西一路/新城街道/自强路/文昌门/中山东路/迎新路
西安-新城-新城街道	中山东路/自强路/解放门/西五路/西一路/尚勤路
西安-新城-胡家庙	长乐西路/长乐中路/互助路立交/长缨东路/西京医院/金花路
西安-未央-经济技术开发区	凤城一路/雅荷花园/二府庄/方新村/张家堡/辛家庙
西安-未央-文景路	凤城四路/张家堡/辛家庙/凤城一路/经济技术开发区/雅荷花园
西安-未央-雅荷花园	经济技术开发区/凤城一路/二府庄/方新村/张家堡/辛家庙
西安-未央-辛家庙	张家堡/雅荷花园/经济技术开发区/凤城一路/文景路/二府庄
西安-未央-凤城一路	经济技术开发区/雅荷花园/二府庄/方新村/张家堡/辛家庙
西安-未央-草滩	徐家湾/辛家庙/张家堡/雅荷花园/经济技术开发区/凤城一路
西安-未央-二府庄	方新村/龙首村/凤城一路/经济技术开发区/雅荷花园/张家堡
西安-未央-大观园	凤城四路/文景路/方新村/龙首村/二府庄/凤城一路
西安-未央-凤城四路	文景路/张家堡/辛家庙/凤城一路/经济技术开发区/雅荷花园
西安-未央-三桥	大观园/凤城四路/文景路/方新村/凤城一路/二府庄
西安-未央-徐家湾	草滩/辛家庙/张家堡/雅荷花园/经济技术开发区/凤城一路
西安-未央-龙首村	方新村/二府庄/凤城一路/经济技术开发区/雅荷花园/二马路
西安-未央-二马路	龙首村/二府庄/方新村/经济技术开发区/雅荷花园/凤城一路
西安-未央-方新村	二府庄/龙首村/凤城一路/经济技术开发区/雅荷花园/文景路
西安-未央-张家堡	辛家庙/雅荷花园/经济技术开发区/凤城一路/文景路/二府庄
西安-碑林-广济街	环城南路/南院门/张家村/小雁塔/南大街/长安路
西安-碑林-和平路	大差市/东大街/安西街/安东街/柏树林/东木头市
西安-碑林-东木头市	柏树林/文艺路/东大街/南大街/大差市/和平路
西安-碑林-环城南路	张家村/广济街/南院门/小雁塔/边家村/大学南路
西安-碑林-边家村	大学南路/何家村/张家村/环城南路/广济街/朱雀大街
西安-碑林-大差市	和平路/东大街/安西街/安东街/东木头市/柏树林
西安-碑林-何家村	大学南路/边家村/张家村/环城南路/广济街/朱雀大街
西安-碑林-安东街	安西街/太乙路/东门外/和平路/东关南街/大差市
西安-碑林-柏树林	东木头市/文艺路/东大街/南大街/大差市/和平路
西安-碑林-东门外	东关南街/太乙路/安东街/安西街/和平路/大差市
西安-碑林-太乙路	安东街/东门外/东关南街/安西街/和平路/大差市
西安-碑林-安西街	安东街/和平路/大差市/太乙路/东大街/东门外
西安-碑林-小雁塔	长安路/南院门/南大街/张家村/环城南路/朱雀大街
西安-碑林-长乐坊	东关南街/东门外/太乙路/安东街/安西街/和平路
西安-碑林-东关南街	东门外/太乙路/安东街/长乐坊/安西街/和平路
西安-碑林-朱雀大街	小雁塔/张家村/长安路/环城南路/南院门/广济街
西安-碑林-南大街	南院门/长安路/小雁塔/东木头市/柏树林/文艺路
西安-碑林-东大街	大差市/和平路/安西街/东木头市/柏树林/文艺路
西安-碑林-文艺路	柏树林/东木头市/长安路/南大街/东大街/和平路
西安-碑林-南院门	广济街/小雁塔/南大街/环城南路/张家村/长安路
西安-碑林-长安路	小雁塔/南大街/文艺路/南院门/朱雀大街/柏树林
西安-碑林-大学南路	边家村/何家村/张家村/环城南路/广济街/朱雀大街
西安-碑林-张家村	环城南路/广济街/南院门/小雁塔/边家村/朱雀大街
西安-阎良-关山	武屯/新华路/凤凰路
西安-阎良-凤凰路	新华路/武屯/关山
西安-阎良-武屯	新华路/凤凰路/关山
西安-阎良-新华路	凤凰路/武屯/关山
西安-灞桥-纺织城	红旗/席王/十里铺/洪庆
西安-灞桥-红旗	纺织城/席王/十里铺/洪庆
西安-灞桥-十里铺	红旗/纺织城/席王/洪庆
西安-灞桥-席王	纺织城/红旗/十里铺/洪庆
西安-灞桥-洪庆	席王/纺织城/红旗/十里铺
西安-高新-高新二路	玫瑰大楼/高新四路/高新路/亚美大厦/旺座现代城/唐延路
西安-高新-旺座现代城	唐延路/沣惠南路/科技一路/科技二路/亚美大厦/玫瑰大楼
西安-高新-科技一路	沣惠南路/唐延路/旺座现代城/科技二路/亚美大厦/科技四路西段
西安-高新-沣惠南路	科技一路/唐延路/旺座现代城/科技二路/科技四路西段/亚美大厦
西安-高新-光华路	高新路/高新二路/玫瑰大楼/高新四路/亚美大厦/旺座现代城
西安-高新-亚美大厦	高新四路/玫瑰大楼/唐延路/旺座现代城/高新二路/科技一路
西安-高新-高新四路	玫瑰大楼/亚美大厦/高新二路/旺座现代城/唐延路/科技一路
西安-高新-玫瑰大楼	高新四路/亚美大厦/高新二路/旺座现代城/唐延路/科技一路
西安-高新-高新路	高新二路/光华路/玫瑰大楼/高新四路/亚美大厦/旺座现代城
西安-高新-唐延路	旺座现代城/沣惠南路/科技一路/科技二路/亚美大厦/玫瑰大楼
西安-高新-科技四路西段	科技二路/沣惠南路/科技一路/唐延路/旺座现代城/科技路西口
西安-高新-科技二路	科技一路/沣惠南路/唐延路/科技四路西段/旺座现代城/亚美大厦
西安-高新-科技路西口	科技四路西段/科技二路/科技一路/沣惠南路/唐延路/旺座现代城
西安-莲湖-昆明路	枣园/城西客运站/土门/高科花园/锦园小区/桃园路
西安-莲湖-北关	北大街/北院门/青年路/庙后街/西大街/甜水井
西安-莲湖-城西客运站	枣园/土门/昆明路/高科花园/锦园小区/桃园路
西安-莲湖-红庙坡	环城西路/西关/庙后街/甜水井/青年路/西大街
西安-莲湖-锦园小区	高科花园/土门/桃园路/丰庆路/西稍门/丰禾路
西安-莲湖-北大街	北院门/北关/青年路/西大街/庙后街/甜水井
西安-莲湖-枣园	城西客运站/昆明路/土门/高科花园/锦园小区/桃园路
西安-莲湖-青年路	庙后街/西大街/北院门/甜水井/北大街/北关
西安-莲湖-丰禾路	西稍门/桃园路/丰庆路/西关/锦园小区/红庙坡
西安-莲湖-环城西路	红庙坡/西关/庙后街/甜水井/青年路/西大街
西安-莲湖-桃园路	西稍门/丰庆路/丰禾路/锦园小区/土门/高科花园
西安-莲湖-西稍门	丰庆路/桃园路/丰禾路/锦园小区/西关/高科花园
西安-莲湖-土门	锦园小区/高科花园/桃园路/城西客运站/西稍门/丰庆路
西安-莲湖-甜水井	西大街/庙后街/青年路/北院门/环城西路/红庙坡
西安-莲湖-北院门	北大街/青年路/西大街/北关/庙后街/甜水井
西安-莲湖-西大街	庙后街/甜水井/青年路/北院门/北大街/环城西路
西安-莲湖-西关	红庙坡/环城西路/甜水井/丰庆路/西稍门/丰禾路
西安-莲湖-庙后街	西大街/青年路/甜水井/北院门/北大街/环城西路
西安-莲湖-高科花园	锦园小区/土门/桃园路/丰庆路/西稍门/丰禾路
西安-莲湖-丰庆路	西稍门/桃园路/丰禾路/锦园小区/西关/高科花园
北京-密云-古北口	太师屯/北庄/新城子/不老屯/穆家峪/溪翁庄
北京-密云-不老屯	穆家峪/太师屯/溪翁庄/密云/古北口/北庄
北京-密云-密云	溪翁庄/十里堡/穆家峪/不老屯/太师屯/北庄
北京-密云-十里堡	密云/溪翁庄/穆家峪/不老屯/太师屯/北庄
北京-密云-溪翁庄	密云/十里堡/穆家峪/不老屯/太师屯/古北口
北京-密云-太师屯	北庄/古北口/不老屯/穆家峪/新城子/溪翁庄
北京-密云-新城子	北庄/古北口/太师屯/不老屯/穆家峪/溪翁庄
北京-密云-穆家峪	不老屯/密云/溪翁庄/十里堡/太师屯/北庄
北京-密云-北庄	太师屯/古北口/新城子/不老屯/穆家峪/溪翁庄
北京-石景山-八大处	杨庄/八角/苹果园/古城/老山/衙门口
北京-石景山-西山	金顶街/模式口/苹果园/古城/广宁/杨庄
北京-石景山-玉泉路	八宝山/鲁谷/老山/衙门口/八角/八大处
北京-石景山-八角	杨庄/古城/八大处/苹果园/衙门口/老山
北京-石景山-古城	苹果园/杨庄/八角/八大处/金顶街/西山
北京-石景山-模式口	金顶街/西山/广宁/苹果园/古城/五里坨
北京-石景山-八宝山	玉泉路/鲁谷/老山/衙门口/八角/杨庄
北京-石景山-杨庄	八角/古城/八大处/苹果园/老山/衙门口
北京-石景山-广宁	模式口/五里坨/金顶街/西山/苹果园/古城
北京-石景山-五里坨	广宁/模式口/西山/金顶街/苹果园/古城
北京-石景山-老山	鲁谷/衙门口/八角/八宝山/杨庄/八大处
北京-石景山-金顶街	西山/模式口/苹果园/古城/广宁/杨庄
北京-石景山-衙门口	鲁谷/老山/八角/杨庄/八宝山/古城
北京-石景山-鲁谷	老山/衙门口/八宝山/八角/杨庄/玉泉路
北京-石景山-苹果园	古城/杨庄/八大处/八角/金顶街/西山
北京-通州-北苑	果园/北关环岛/九棵树/新华大街/梨园/梨园城铁
北京-通州-梨园	梨园城铁/九棵树/临河里/新华大街/玉桥/土桥
北京-通州-乔庄	玉桥/土桥/临河里/武夷花园/梨园城铁/梨园
北京-通州-次渠	马驹桥/北苑/果园/九棵树/梨园/北关环岛
北京-通州-新华大街	北关环岛/九棵树/梨园城铁/梨园/玉桥/果园
北京-通州-临河里	土桥/玉桥/梨园城铁/乔庄/梨园/新华大街
北京-通州-梨园城铁	梨园/玉桥/九棵树/临河里/新华大街/土桥
北京-通州-土桥	临河里/乔庄/玉桥/梨园城铁/梨园/武夷花园
北京-通州-潞苑	潞城/土桥/武夷花园/乔庄/临河里/玉桥
北京-通州-北关环岛	新华大街/九棵树/果园/北苑/梨园城铁/梨园
北京-通州-潞城	武夷花园/乔庄/土桥/潞苑/玉桥/临河里
北京-通州-马驹桥	次渠/北苑/果园/九棵树/梨园/北关环岛
北京-通州-果园	北苑/九棵树/北关环岛/新华大街/梨园/梨园城铁
北京-通州-武夷花园	乔庄/玉桥/土桥/潞城/临河里/梨园城铁
北京-通州-玉桥	临河里/乔庄/梨园城铁/土桥/梨园/新华大街
北京-通州-九棵树	梨园/新华大街/梨园城铁/果园/北关环岛/玉桥
北京-房山-长阳	良乡/阎村/窦店/房山城关/迎风/韩村河
北京-房山-窦店	阎村/良乡/房山城关/韩村河/迎风/长阳
北京-房山-韩村河	房山城关/迎风/窦店/阎村/良乡/长阳
北京-房山-迎风	房山城关/韩村河/窦店/阎村/良乡/长阳
北京-房山-阎村	窦店/良乡/长阳/房山城关/迎风/韩村河
北京-房山-房山城关	迎风/韩村河/窦店/阎村/良乡/长阳
北京-房山-良乡	长阳/阎村/窦店/房山城关/迎风/韩村河
北京-顺义-石园	仁和/光明/胜利/马坡/李桥/机场
北京-顺义-后沙峪	新国展/天竺/机场/李桥/胜利/光明
北京-顺义-李桥	仁和/石园/光明/胜利/机场/马坡
北京-顺义-仁和	石园/光明/胜利/李桥/马坡/机场
北京-顺义-新国展	后沙峪/天竺/机场/李桥/胜利/光明
北京-顺义-天竺	机场/新国展/后沙峪/李桥/胜利/仁和
北京-顺义-杨镇	南彩/石园/仁和/光明/马坡/胜利
北京-顺义-机场	天竺/李桥/新国展/后沙峪/胜利/仁和
北京-顺义-胜利	光明/石园/马坡/仁和/李桥/机场
北京-顺义-光明	石园/胜利/仁和/马坡/李桥/机场
北京-顺义-马坡	胜利/光明/石园/仁和/李桥/机场
北京-顺义-南彩	石园/仁和/光明/杨镇/马坡/胜利
北京-昌平-小汤山	兴寿/北七家/霍营/天通苑/立水桥/百善
北京-昌平-天通苑	立水桥/北七家/霍营/小汤山/兴寿/回龙观
北京-昌平-昌平县城	城北/城南/十三陵/长陵/南邵/沙河镇
北京-昌平-阳坊	马池口/南口/城南/昌平县城/城北/十三陵
北京-昌平-立水桥	天通苑/北七家/霍营/小汤山/兴寿/回龙观
北京-昌平-龙泽	回龙观/百善/霍营/沙河镇/南邵/小汤山
北京-昌平-长陵	十三陵/城北/昌平县城/南邵/城南/沙河镇
北京-昌平-城南	昌平县城/城北/十三陵/马池口/长陵/沙河镇
北京-昌平-回龙观	龙泽/霍营/百善/沙河镇/小汤山/南邵
北京-昌平-马池口	阳坊/南口/城南/昌平县城/城北/十三陵
北京-昌平-城北	昌平县城/十三陵/城南/长陵/南邵/沙河镇
北京-昌平-十三陵	城北/昌平县城/城南/长陵/南邵/马池口
北京-昌平-北七家	天通苑/立水桥/小汤山/兴寿/霍营/回龙观
北京-昌平-百善	南邵/回龙观/龙泽/沙河镇/霍营/小汤山
北京-昌平-霍营	回龙观/龙泽/天通苑/立水桥/小汤山/百善
北京-昌平-兴寿	小汤山/北七家/天通苑/霍营/立水桥/百善
北京-昌平-南口	马池口/阳坊/城南/十三陵/昌平县城/城北
北京-昌平-沙河镇	南邵/百善/龙泽/昌平县城/城北/回龙观
北京-昌平-南邵	百善/沙河镇/长陵/城北/昌平县城/十三陵
北京-丰台-菜户营	玉泉营/草桥/右安门/嘉园/马连道/新发地
北京-丰台-青塔	岳各庄/五里店/丰台体育馆/丰台路/北大地/七里庄
北京-丰台-木樨园	赵公口/大红门/西罗园/洋桥/蒲黄榆/和义
北京-丰台-大红门	赵公口/和义/木樨园/南苑/东高地/刘家窑
北京-丰台-和义	南苑/大红门/东高地/赵公口/木樨园/刘家窑
北京-丰台-洋桥	西罗园/角门/木樨园/马家堡/大红门/嘉园
北京-丰台-马连道	西客站/丰益桥/玉泉营/菜户营/丽泽桥/六里桥
北京-丰台-丰益桥	丽泽桥/花乡/六里桥/马连道/西客站/七里庄
北京-丰台-云岗	长辛店/卢沟桥/五里店/青塔/岳各庄/丰台体育馆
北京-丰台-嘉园	草桥/马家堡/右安门/角门/新宫/菜户营
北京-丰台-右安门	嘉园/马家堡/草桥/菜户营/角门/洋桥
北京-丰台-南苑	和义/大红门/东高地/木樨园/赵公口/西罗园
北京-丰台-西客站	六里桥/马连道/丽泽桥/丰益桥/花乡/玉泉营
北京-丰台-世界公园	科技园区/北大地/七里庄/花乡/丰台路/丰台体育馆
北京-丰台-丰台路	丰台体育馆/北大地/岳各庄/七里庄/科技园区/青塔
北京-丰台-蒲黄榆	刘家窑/赵公口/宋家庄/木樨园/大红门/方庄
北京-丰台-卢沟桥	五里店/长辛店/青塔/岳各庄/丰台体育馆/丰台路
北京-丰台-马家堡	嘉园/角门/右安门/草桥/洋桥/西罗园
北京-丰台-六里桥	丽泽桥/西客站/丰益桥/七里庄/马连道/花乡
北京-丰台-刘家窑	蒲黄榆/宋家庄/赵公口/方庄/大红门/左安门
北京-丰台-赵公口	木樨园/大红门/蒲黄榆/刘家窑/宋家庄/西罗园
北京-丰台-丰台体育馆	丰台路/北大地/岳各庄/七里庄/青塔/科技园区
北京-丰台-五里店	青塔/岳各庄/丰台体育馆/卢沟桥/丰台路/北大地
北京-丰台-成寿寺	方庄/左安门/宋家庄/刘家窑/蒲黄榆/东高地
北京-丰台-西罗园	洋桥/木樨园/角门/大红门/赵公口/马家堡
北京-丰台-长辛店	卢沟桥/云岗/五里店/青塔/岳各庄/丰台体育馆
北京-丰台-东高地	和义/南苑/大红门/宋家庄/刘家窑/赵公口
北京-丰台-科技园区	世界公园/北大地/七里庄/丰台路/丰台体育馆/花乡
北京-丰台-丽泽桥	丰益桥/六里桥/西客站/花乡/马连道/七里庄
北京-丰台-七里庄	北大地/丰台路/丰台体育馆/科技园区/岳各庄/丽泽桥
北京-丰台-岳各庄	丰台体育馆/丰台路/北大地/青塔/七里庄/五里店
北京-丰台-新宫	草桥/嘉园/新发地/马家堡/玉泉营/右安门
北京-丰台-新发地	玉泉营/新宫/草桥/菜户营/嘉园/马连道
北京-丰台-左安门	方庄/成寿寺/宋家庄/刘家窑/蒲黄榆/赵公口
北京-丰台-花乡	丰益桥/丽泽桥/科技园区/六里桥/七里庄/世界公园
北京-丰台-北大地	丰台路/丰台体育馆/七里庄/岳各庄/科技园区/世界公园
北京-丰台-草桥	嘉园/右安门/马家堡/菜户营/新宫/玉泉营
北京-丰台-玉泉营	菜户营/新发地/草桥/马连道/新宫/嘉园
北京-丰台-方庄	左安门/成寿寺/宋家庄/刘家窑/蒲黄榆/赵公口
北京-丰台-角门	洋桥/马家堡/西罗园/嘉园/右安门/草桥
北京-丰台-宋家庄	刘家窑/蒲黄榆/方庄/左安门/成寿寺/赵公口
北京-宣武-菜市口	宣武门/陶然亭/虎坊桥/牛街/长椿街/和平门
北京-宣武-右安门	白纸坊/牛街/白广路/长椿街/南菜园/菜市口
北京-宣武-前门	天桥/和平门/虎坊桥/陶然亭/宣武门/菜市口
北京-宣武-西客站	马连道/红莲/广安门/南菜园/白广路/白纸坊
北京-宣武-天桥	前门/虎坊桥/和平门/陶然亭/菜市口/宣武门
北京-宣武-宣武门	菜市口/和平门/虎坊桥/长椿街/陶然亭/牛街
北京-宣武-长椿街	牛街/白广路/白纸坊/右安门/菜市口/宣武门
北京-宣武-白广路	白纸坊/牛街/长椿街/南菜园/右安门/广安门
北京-宣武-马连道	西客站/红莲/广安门/南菜园/白广路/白纸坊
北京-宣武-牛街	长椿街/白广路/白纸坊/右安门/菜市口/南菜园
北京-宣武-南菜园	白纸坊/白广路/广安门/右安门/牛街/长椿街
北京-宣武-广安门	南菜园/白广路/白纸坊/红莲/长椿街/牛街
北京-宣武-和平门	虎坊桥/宣武门/陶然亭/菜市口/前门/天桥
北京-宣武-陶然亭	虎坊桥/菜市口/和平门/宣武门/天桥/前门
北京-宣武-白纸坊	白广路/右安门/牛街/南菜园/长椿街/广安门
北京-宣武-红莲	马连道/西客站/广安门/南菜园/白广路/白纸坊
北京-宣武-虎坊桥	和平门/陶然亭/菜市口/宣武门/前门/天桥
北京-怀柔-泉河	怀柔/庙城/雁栖/桥梓/杨宋/北房
北京-怀柔-北房	杨宋/怀北/雁栖/怀柔/泉河/庙城
北京-怀柔-怀柔	泉河/庙城/雁栖/杨宋/桥梓/北房
北京-怀柔-怀北	北房/雁栖/杨宋/怀柔/泉河/庙城
北京-怀柔-九渡河	渤海镇/桥梓/庙城/泉河/怀柔/雁栖
北京-怀柔-杨宋	北房/雁栖/怀北/怀柔/庙城/泉河
北京-怀柔-渤海镇	九渡河/桥梓/泉河/庙城/怀柔/雁栖
北京-怀柔-汤河口	怀北/雁栖/泉河/怀柔/北房/庙城
北京-怀柔-雁栖	怀柔/泉河/怀北/北房/杨宋/庙城
北京-怀柔-桥梓	庙城/泉河/怀柔/雁栖/杨宋/北房
北京-怀柔-庙城	怀柔/泉河/雁栖/桥梓/杨宋/北房
北京-平谷-东高村	滨河/渔阳/兴谷/平谷镇/王辛庄/熊儿寨
北京-平谷-王辛庄	平谷镇/滨河/渔阳/兴谷/东高村/熊儿寨
北京-平谷-熊儿寨	镇罗营/兴谷/王辛庄/渔阳/滨河/平谷镇
北京-平谷-金海湖	黄松峪/熊儿寨/镇罗营/兴谷/渔阳/东高村
北京-平谷-峪口	刘家店/马昌营/平谷镇/王辛庄/滨河/渔阳
北京-平谷-刘家店	峪口/马昌营/王辛庄/平谷镇/滨河/渔阳
北京-平谷-镇罗营	熊儿寨/兴谷/王辛庄/渔阳/滨河/平谷镇
北京-平谷-滨河	渔阳/平谷镇/王辛庄/兴谷/东高村/熊儿寨
北京-平谷-黄松峪	金海湖/熊儿寨/镇罗营/兴谷/渔阳/东高村
北京-平谷-马昌营	峪口/刘家店/平谷镇/王辛庄/滨河/渔阳
北京-平谷-兴谷	渔阳/滨河/王辛庄/东高村/平谷镇/熊儿寨
北京-平谷-渔阳	滨河/兴谷/王辛庄/平谷镇/东高村/熊儿寨
北京-平谷-平谷镇	王辛庄/滨河/渔阳/东高村/兴谷/熊儿寨
北京-海淀-双榆树	人民大学/魏公村/中关村/知春路/北大清华/皂君庙
北京-海淀-万柳	万泉河/苏州街/车道沟/世纪城/西苑/北洼路
北京-海淀-万寿路	定慧寺/北洼路/公主坟/车道沟/航天桥/花园桥
北京-海淀-军博	增光路/公主坟/甘家口/航天桥/白石桥/花园桥
北京-海淀-小营	清河/西三旗/五道口/学院路/西二旗/知春路
北京-海淀-魏公村	万寿寺/人民大学/紫竹桥/双榆树/白石桥/增光路
北京-海淀-万泉河	苏州街/西苑/万柳/中关村/北大清华/车道沟
北京-海淀-西三旗	小营/西二旗/上地/清河/五道口/北大清华
北京-海淀-西二旗	上地/西三旗/北大清华/小营/中关村/万泉河
北京-海淀-北太平庄	牡丹园/马甸/二里庄/蓟门桥/西直门/学院路
北京-海淀-航天桥	花园桥/公主坟/紫竹桥/北洼路/万寿寺/车道沟
北京-海淀-西北旺	马连洼/西苑/四季青/世纪城/万泉河/上地
北京-海淀-中关村	北大清华/人民大学/双榆树/苏州街/魏公村/万泉河
北京-海淀-二里庄	牡丹园/北太平庄/学院路/马甸/蓟门桥/清河
北京-海淀-五道口	知春路/大钟寺/学院路/皂君庙/蓟门桥/双榆树
北京-海淀-白石桥	增光路/甘家口/魏公村/皂君庙/双榆树/军博
北京-海淀-马甸	北太平庄/牡丹园/二里庄/蓟门桥/西直门/学院路
北京-海淀-北洼路	车道沟/紫竹桥/花园桥/航天桥/万寿寺/万寿路
北京-海淀-人民大学	双榆树/中关村/魏公村/北大清华/万寿寺/苏州街
北京-海淀-车道沟	北洼路/紫竹桥/花园桥/万寿寺/航天桥/万柳
北京-海淀-皂君庙	交通大学/大钟寺/知春路/白石桥/蓟门桥/双榆树
北京-海淀-知春路	皂君庙/五道口/大钟寺/双榆树/交通大学/蓟门桥
北京-海淀-西苑	万泉河/万柳/苏州街/世纪城/北大清华/中关村
北京-海淀-牡丹园	北太平庄/二里庄/马甸/学院路/蓟门桥/西直门
北京-海淀-马连洼	西北旺/西苑/万泉河/世纪城/四季青/上地
北京-海淀-定慧寺	万寿路/五棵松/世纪城/四季青/北洼路/永定路
北京-海淀-花园桥	航天桥/紫竹桥/万寿寺/北洼路/车道沟/公主坟
北京-海淀-北大清华	中关村/人民大学/苏州街/双榆树/万泉河/魏公村
北京-海淀-上地	西二旗/北大清华/西三旗/中关村/万泉河/西苑
北京-海淀-永定路	五棵松/田村/四季青/定慧寺/世纪城/万寿路
北京-海淀-紫竹桥	万寿寺/花园桥/车道沟/北洼路/航天桥/魏公村
北京-海淀-苏州街	万泉河/万柳/中关村/北大清华/人民大学/万寿寺
北京-海淀-万寿寺	紫竹桥/花园桥/魏公村/车道沟/航天桥/北洼路
北京-海淀-四季青	世纪城/定慧寺/田村/永定路/五棵松/万柳
北京-海淀-甘家口	白石桥/增光路/军博/交通大学/皂君庙/魏公村
北京-海淀-田村	永定路/四季青/五棵松/定慧寺/世纪城/万寿路
北京-海淀-香山	田村/西北旺/四季青/永定路/马连洼/五棵松
北京-海淀-大钟寺	蓟门桥/交通大学/皂君庙/知春路/五道口/学院路
北京-海淀-增光路	白石桥/军博/甘家口/魏公村/花园桥/航天桥
北京-海淀-公主坟	航天桥/花园桥/军博/北洼路/万寿路/增光路
北京-海淀-交通大学	大钟寺/皂君庙/蓟门桥/西直门/知春路/甘家口
北京-海淀-清河	小营/学院路/五道口/西三旗/二里庄/知春路
北京-海淀-世纪城	万柳/四季青/定慧寺/西苑/万泉河/车道沟
北京-海淀-学院路	蓟门桥/五道口/大钟寺/二里庄/清河/知春路
北京-海淀-五棵松	永定路/定慧寺/四季青/万寿路/田村/世纪城
北京-海淀-西直门	交通大学/蓟门桥/大钟寺/皂君庙/北太平庄/甘家口
北京-海淀-蓟门桥	大钟寺/交通大学/学院路/西直门/皂君庙/知春路
北京-西城-三里河	木樨地/百万庄/展览路/月坛/南礼士路/西便门
北京-西城-木樨地	三里河/百万庄/展览路/月坛/南礼士路/西便门
北京-西城-展览路	百万庄/月坛/三里河/车公庄/木樨地/南礼士路
北京-西城-六铺炕	什刹海/后海/德胜门/积水潭/小西天/新街口
北京-西城-阜成门	车公庄/金融街/官园/南礼士路/月坛/复兴门
北京-西城-金融街	复兴门/阜成门/官园/南礼士路/西便门/车公庄
北京-西城-后海	德胜门/什刹海/积水潭/六铺炕/新街口/小西天
北京-西城-官园	西直门/阜成门/金融街/车公庄/新街口/复兴门
北京-西城-南礼士路	月坛/西便门/复兴门/阜成门/金融街/车公庄
北京-西城-复兴门	金融街/西便门/南礼士路/阜成门/月坛/官园
北京-西城-西单	西四/新街口/金融街/官园/后海/积水潭
北京-西城-德胜门	后海/积水潭/小西天/新街口/六铺炕/什刹海
北京-西城-小西天	积水潭/新街口/德胜门/后海/西四/西直门
北京-西城-西便门	南礼士路/复兴门/月坛/金融街/阜成门/展览路
北京-西城-西四	西单/新街口/积水潭/后海/官园/小西天
北京-西城-月坛	南礼士路/展览路/西便门/阜成门/车公庄/复兴门
北京-西城-积水潭	小西天/新街口/德胜门/后海/西四/官园
北京-西城-车公庄	阜成门/西直门/展览路/官园/月坛/南礼士路
北京-西城-百万庄	展览路/三里河/木樨地/月坛/车公庄/南礼士路
北京-西城-什刹海	六铺炕/后海/德胜门/西四/积水潭/西单
北京-西城-新街口	积水潭/小西天/西四/德胜门/后海/官园
北京-西城-西直门	官园/车公庄/阜成门/金融街/新街口/小西天
北京-朝阳-呼家楼	CBD/团结湖/国贸/三里屯/水碓子/燕莎
北京-朝阳-芍药居	西坝河/小营/太阳宫/和平街/柳芳/惠新里
北京-朝阳-工体	朝外/东大桥/三里屯/左家庄/建外大街/永安里
北京-朝阳-劲松	潘家园/华威桥/永安里/建外大街/双井/国贸
北京-朝阳-北沙滩	奥运村/健翔桥/安贞/亚运村/安慧桥/大屯
北京-朝阳-惠新里	小营/和平街/小关/安慧桥/亚运村/芍药居
北京-朝阳-大屯	亚运村/安慧桥/小关/安贞/惠新里/小营
北京-朝阳-双桥	常营/管庄/豆各庄/定福庄/东坝/高碑店
北京-朝阳-小营	惠新里/芍药居/和平街/小关/大屯/安慧桥
北京-朝阳-南磨房	大望路/北工大/红庙/双井/华威桥/十八里店
北京-朝阳-双井	国贸/华威桥/CBD/劲松/大望路/呼家楼
北京-朝阳-永安里	建外大街/东大桥/朝外/CBD/国贸/劲松
北京-朝阳-水碓子	甜水园/团结湖/呼家楼/红庙/朝阳公园/燕莎
北京-朝阳-大山子	酒仙桥/望京/朝阳公园/花家地/石佛营/甜水园
北京-朝阳-朝青板块	甘露园/高碑店/姚家园/百子湾/十里堡/石佛营
北京-朝阳-百子湾	十里堡/四惠/甘露园/八里庄/石佛营/垡头
北京-朝阳-定福庄	高碑店/东坝/豆各庄/双桥/朝青板块/甘露园
北京-朝阳-高碑店	朝青板块/甘露园/姚家园/定福庄/百子湾/垡头
北京-朝阳-红庙	甜水园/大望路/水碓子/朝阳公园/南磨房/八里庄
北京-朝阳-国贸	CBD/呼家楼/双井/永安里/团结湖/东大桥
北京-朝阳-北工大	南磨房/大望路/红庙/十八里店/四惠/八里庄
北京-朝阳-安慧桥	亚运村/小关/大屯/安贞/惠新里/小营
北京-朝阳-朝外	工体/东大桥/建外大街/永安里/三里屯/CBD
北京-朝阳-亚运村	安慧桥/大屯/小关/安贞/惠新里/小营
北京-朝阳-小红门	华威桥/潘家园/十八里店/劲松/双井/南磨房
北京-朝阳-柳芳	西坝河/左家庄/国展/太阳宫/工体/芍药居
北京-朝阳-东大桥	朝外/永安里/工体/建外大街/三里屯/CBD
北京-朝阳-安贞	安慧桥/小关/亚运村/大屯/惠新里/和平街
北京-朝阳-来广营	望京/花家地/太阳宫/三元桥/大山子/国展
北京-朝阳-十里堡	四惠/八里庄/石佛营/百子湾/甘露园/姚家园
北京-朝阳-太阳宫	国展/西坝河/左家庄/三元桥/柳芳/芍药居
北京-朝阳-管庄	常营/双桥/豆各庄/定福庄/东坝/高碑店
北京-朝阳-垡头	百子湾/甘露园/四惠/十里堡/高碑店/八里庄
北京-朝阳-潘家园	劲松/华威桥/建外大街/永安里/双井/国贸
北京-朝阳-三元桥	燕莎/三里屯/国展/太阳宫/左家庄/工体
北京-朝阳-小关	安慧桥/亚运村/惠新里/大屯/安贞/小营
北京-朝阳-左家庄	国展/西坝河/柳芳/太阳宫/工体/三元桥
北京-朝阳-团结湖	呼家楼/水碓子/燕莎/CBD/国贸/三里屯
北京-朝阳-三里屯	东大桥/三元桥/燕莎/呼家楼/CBD/工体
北京-朝阳-朝阳公园	甜水园/水碓子/红庙/酒仙桥/八里庄/团结湖
北京-朝阳-酒仙桥	大山子/朝阳公园/石佛营/甜水园/八里庄/望京
北京-朝阳-国展	左家庄/太阳宫/西坝河/柳芳/三元桥/工体
北京-朝阳-建外大街	永安里/东大桥/朝外/CBD/工体/国贸
北京-朝阳-望京	花家地/来广营/大山子/燕莎/三元桥/太阳宫
北京-朝阳-姚家园	朝青板块/甘露园/石佛营/十里堡/高碑店/百子湾
北京-朝阳-东坝	定福庄/高碑店/朝青板块/姚家园/双桥/常营
北京-朝阳-和平街	惠新里/小营/芍药居/小关/柳芳/西坝河
北京-朝阳-常营	管庄/双桥/定福庄/豆各庄/东坝/高碑店
北京-朝阳-四惠	八里庄/十里堡/百子湾/石佛营/红庙/甘露园
北京-朝阳-八里庄	四惠/十里堡/石佛营/百子湾/红庙/朝阳公园
北京-朝阳-北苑	大屯/小营/亚运村/安慧桥/惠新里/小关
北京-朝阳-CBD	国贸/呼家楼/永安里/东大桥/三里屯/建外大街
北京-朝阳-大望路	南磨房/北工大/红庙/双井/甜水园/水碓子
北京-朝阳-甜水园	水碓子/朝阳公园/红庙/团结湖/大望路/呼家楼
北京-朝阳-花家地	望京/来广营/三元桥/燕莎/太阳宫/大山子
北京-朝阳-豆各庄	定福庄/双桥/高碑店/常营/管庄/东坝
北京-朝阳-华威桥	劲松/双井/潘家园/国贸/南磨房/小红门
北京-朝阳-十八里店	北工大/南磨房/大望路/小红门/华威桥/双井
北京-朝阳-甘露园	朝青板块/百子湾/姚家园/十里堡/高碑店/石佛营
北京-朝阳-石佛营	十里堡/八里庄/四惠/姚家园/百子湾/甘露园
北京-朝阳-奥运村	健翔桥/北沙滩/亚运村/大屯/安贞/安慧桥
北京-朝阳-燕莎	三元桥/团结湖/三里屯/呼家楼/水碓子/CBD
北京-朝阳-健翔桥	奥运村/北沙滩/安贞/安慧桥/亚运村/大屯
北京-朝阳-西坝河	左家庄/柳芳/国展/太阳宫/芍药居/工体
北京-大兴-旧宫	亦庄/西红门/黄村/庞各庄
北京-大兴-黄村	西红门/庞各庄/旧宫/亦庄
北京-大兴-庞各庄	黄村/西红门/旧宫/亦庄
北京-大兴-亦庄	旧宫/西红门/黄村/庞各庄
北京-大兴-西红门	黄村/庞各庄/旧宫/亦庄
北京-门头沟-妙峰山	东辛房/龙泉/潭柘寺/大峪/城子街道/军庄
北京-门头沟-军庄	城子街道/龙泉/大峪/永定/东辛房/妙峰山
北京-门头沟-大峪	龙泉/城子街道/东辛房/永定/军庄/妙峰山
北京-门头沟-龙泉	大峪/城子街道/东辛房/永定/军庄/妙峰山
北京-门头沟-永定	大峪/龙泉/城子街道/东辛房/军庄/妙峰山
北京-门头沟-城子街道	龙泉/大峪/永定/军庄/东辛房/妙峰山
北京-门头沟-潭柘寺	妙峰山/东辛房/大峪/龙泉/城子街道/永定
北京-门头沟-清水	潭柘寺/妙峰山/东辛房/龙泉/大峪/城子街道
北京-门头沟-东辛房	龙泉/大峪/城子街道/妙峰山/永定/军庄
北京-东城-东直门	东四十条/朝阳门/海运仓/北新桥/建国门/和平里
北京-东城-建国门	朝阳门/东四十条/东直门/海运仓/东单/北新桥
北京-东城-安定门	交道口/景山/雍和宫/鼓楼/沙滩/东四
北京-东城-东四十条	东直门/朝阳门/海运仓/北新桥/建国门/和平里
北京-东城-景山	沙滩/交道口/王府井/灯市口/鼓楼/安定门
北京-东城-沙滩	景山/交道口/王府井/安定门/灯市口/鼓楼
北京-东城-东单	灯市口/东四/王府井/鼓楼/海运仓/景山
北京-东城-鼓楼	东四/灯市口/雍和宫/交道口/景山/王府井
北京-东城-灯市口	王府井/鼓楼/东四/景山/东单/交道口
北京-东城-朝阳门	东四十条/建国门/东直门/海运仓/北新桥/东单
北京-东城-东四	鼓楼/灯市口/北新桥/东单/雍和宫/王府井
北京-东城-交道口	安定门/景山/鼓楼/沙滩/雍和宫/灯市口
北京-东城-北新桥	海运仓/和平里/雍和宫/东四/东四十条/鼓楼
北京-东城-和平里	北新桥/雍和宫/海运仓/鼓楼/东四/东四十条
北京-东城-海运仓	北新桥/东四十条/东直门/朝阳门/和平里/东四
北京-东城-王府井	灯市口/景山/东单/沙滩/鼓楼/东四
北京-东城-雍和宫	和平里/鼓楼/北新桥/交道口/东四/安定门
北京-崇文-龙潭湖	光明楼/广渠门/体育馆路/花市/法华寺/崇文门
北京-崇文-崇文门	法华寺/天坛/花市/体育馆路/前门/龙潭湖
北京-崇文-天坛	崇文门/法华寺/体育馆路/前门/永定门/花市
北京-崇文-前门	永定门/天坛/沙子口/崇文门/法华寺/体育馆路
北京-崇文-法华寺	体育馆路/花市/崇文门/天坛/龙潭湖/光明楼
北京-崇文-沙子口	永定门/前门/天坛/崇文门/法华寺/体育馆路
北京-崇文-花市	法华寺/体育馆路/崇文门/龙潭湖/光明楼/天坛
北京-崇文-永定门	沙子口/前门/天坛/崇文门/法华寺/体育馆路
北京-崇文-体育馆路	法华寺/花市/崇文门/龙潭湖/天坛/光明楼
北京-崇文-广渠门	光明楼/龙潭湖/花市/体育馆路/法华寺/崇文门
北京-崇文-光明楼	龙潭湖/广渠门/体育馆路/花市/法华寺/崇文门
北京-延庆-大榆树	八达岭/延庆/康庄/永宁
北京-延庆-永宁	大榆树/八达岭/延庆/康庄
北京-延庆-康庄	延庆/八达岭/大榆树/永宁
北京-延庆-八达岭	大榆树/延庆/康庄/永宁
北京-延庆-延庆	大榆树/八达岭/康庄/永宁
北京-北京周边-三河	香河
北京-北京周边-香河	三河
苏州-沧浪-双塔	南门/葑门/吴门桥/胥江/沧浪新城/友新
苏州-沧浪-葑门	双塔/南门/吴门桥/胥江/沧浪新城/友新
苏州-沧浪-胥江	吴门桥/沧浪新城/南门/友新/双塔/葑门
苏州-沧浪-吴门桥	胥江/沧浪新城/南门/友新/双塔/葑门
苏州-沧浪-沧浪新城	吴门桥/胥江/南门/友新/双塔/葑门
苏州-沧浪-友新	胥江/吴门桥/沧浪新城/南门/双塔/葑门
苏州-沧浪-南门	双塔/吴门桥/胥江/沧浪新城/葑门/友新
苏州-昆山-周市	玉山/陆家/千灯/张浦/巴城/花桥
苏州-昆山-花桥	陆家/淀山湖/千灯/周市/玉山/张浦
苏州-昆山-玉山	张浦/周市/千灯/巴城/陆家/锦溪
苏州-昆山-千灯	淀山湖/陆家/张浦/玉山/花桥/周市
苏州-昆山-周庄	锦溪/张浦/千灯/玉山/巴城/淀山湖
苏州-昆山-巴城	玉山/张浦/周市/锦溪/千灯/周庄
苏州-昆山-陆家	花桥/千灯/淀山湖/周市/玉山/张浦
苏州-昆山-锦溪	周庄/张浦/千灯/玉山/淀山湖/巴城
苏州-昆山-淀山湖	千灯/陆家/花桥/张浦/玉山/锦溪
苏州-昆山-张浦	玉山/千灯/锦溪/淀山湖/周市/陆家
苏州-新区-通安	阳山/科技城/浒墅关/东渚/狮山/镇湖
苏州-新区-横塘	枫桥/狮山/浒墅关/阳山/通安/科技城
苏州-新区-科技城	东渚/通安/阳山/镇湖/浒墅关/狮山
苏州-新区-东渚	科技城/镇湖/通安/阳山/浒墅关/狮山
苏州-新区-阳山	浒墅关/通安/科技城/狮山/东渚/镇湖
苏州-新区-镇湖	东渚/科技城/通安/阳山/浒墅关/狮山
苏州-新区-浒墅关	阳山/通安/狮山/科技城/东渚/镇湖
苏州-新区-狮山	浒墅关/阳山/通安/科技城/东渚/镇湖
苏州-新区-枫桥	横塘/狮山/浒墅关/阳山/通安/科技城
苏州-吴江市-横扇	震泽/平望/桃源/松陵/盛泽/七都
苏州-吴江市-松陵	同里/平望/横扇/盛泽/震泽/汾湖
苏州-吴江市-同里	松陵/平望/盛泽/汾湖/横扇/震泽
苏州-吴江市-七都	震泽/桃源/横扇/平望/盛泽/松陵
苏州-吴江市-汾湖	同里/盛泽/平望/松陵/横扇/震泽
苏州-吴江市-桃源	震泽/横扇/七都/平望/盛泽/松陵
苏州-吴江市-盛泽	平望/松陵/横扇/同里/震泽/桃源
苏州-吴江市-震泽	桃源/横扇/七都/平望/盛泽/松陵
苏州-吴江市-平望	盛泽/松陵/横扇/同里/震泽/桃源
苏州-园区-唯亭	胜浦/湖东/独墅湖/青剑湖/湖西/娄葑
苏州-园区-东环路	娄葑/湖西/青剑湖/独墅湖/湖东/唯亭
苏州-园区-青剑湖	湖东/湖西/独墅湖/娄葑/东环路/唯亭
苏州-园区-湖西	娄葑/东环路/青剑湖/湖东/独墅湖/唯亭
苏州-园区-胜浦	唯亭/湖东/独墅湖/青剑湖/湖西/娄葑
苏州-园区-独墅湖	湖东/青剑湖/湖西/娄葑/东环路/唯亭
苏州-园区-娄葑	湖西/东环路/青剑湖/湖东/独墅湖/唯亭
苏州-园区-湖东	独墅湖/青剑湖/湖西/娄葑/唯亭/东环路
苏州-金阊-石路	留园/彩香/虎丘/白洋湾
苏州-金阊-白洋湾	虎丘/留园/彩香/石路
苏州-金阊-虎丘	彩香/留园/石路/白洋湾
苏州-金阊-彩香	留园/石路/虎丘/白洋湾
苏州-金阊-留园	彩香/石路/虎丘/白洋湾
苏州-平江-娄门	平江/观前/桃花坞/平江新城/城北/苏锦
苏州-平江-平江新城	桃花坞/苏锦/平江/观前/娄门/城北
苏州-平江-观前	平江/桃花坞/娄门/平江新城/苏锦/城北
苏州-平江-苏锦	桃花坞/平江新城/平江/观前/娄门/城北
苏州-平江-城北	观前/平江/娄门/桃花坞/平江新城/苏锦
苏州-平江-桃花坞	平江新城/观前/平江/苏锦/娄门/城北
苏州-平江-平江	观前/桃花坞/娄门/平江新城/苏锦/城北
苏州-吴中-郭巷	苏苑/胥口/开发区/长桥/临湖/龙西
苏州-吴中-木渎	越溪/城南/龙西/长桥/开发区/胥口
苏州-吴中-f直	横泾/临湖/郭巷/苏苑/胥口/开发区
苏州-吴中-香山	光福/东山/西山/木渎/越溪/城南
苏州-吴中-临湖	郭巷/苏苑/胥口/开发区/长桥/龙西
苏州-吴中-城南	龙西/长桥/开发区/苏苑/胥口/越溪
苏州-吴中-胥口	开发区/长桥/苏苑/龙西/城南/郭巷
苏州-吴中-苏苑	胥口/开发区/长桥/龙西/城南/郭巷
苏州-吴中-光福	香山/东山/西山/木渎/越溪/城南
苏州-吴中-东山	香山/光福/西山/木渎/越溪/城南
苏州-吴中-横泾	f直/临湖/郭巷/苏苑/胥口/开发区
苏州-吴中-长桥	开发区/胥口/苏苑/龙西/城南/越溪
苏州-吴中-西山	香山/东山/光福/木渎/越溪/城南
苏州-吴中-开发区	胥口/长桥/苏苑/龙西/城南/郭巷
苏州-吴中-龙西	城南/长桥/开发区/胥口/苏苑/越溪
苏州-吴中-越溪	龙西/城南/长桥/开发区/胥口/苏苑
苏州-相城-元和	陆慕/开发区/渭塘/北桥/黄埭/太平
苏州-相城-北桥	渭塘/黄埭/元和/陆慕/开发区/太平
苏州-相城-望亭	黄埭/北桥/陆慕/元和/开发区/渭塘
苏州-相城-陆慕	元和/开发区/渭塘/黄埭/北桥/太平
苏州-相城-黄桥	阳澄湖/太平/渭塘/开发区/元和/陆慕
苏州-相城-黄埭	北桥/元和/陆慕/开发区/渭塘/望亭
苏州-相城-渭塘	太平/开发区/北桥/元和/阳澄湖/陆慕
苏州-相城-阳澄湖	太平/渭塘/开发区/北桥/元和/陆慕
苏州-相城-太平	阳澄湖/渭塘/开发区/元和/陆慕/北桥
苏州-相城-开发区	元和/陆慕/渭塘/太平/北桥/黄埭
南京-下关-宝塔桥	阅江楼/大桥南路/金陵小区/建宁路/热河南路/三汊河
南京-下关-五塘	幕府山/小市/建宁路/金陵小区/大桥南路/宝塔桥
南京-下关-建宁路	金陵小区/大桥南路/阅江楼/宝塔桥/五塘/幕府山
南京-下关-大桥南路	阅江楼/宝塔桥/建宁路/金陵小区/热河南路/三汊河
南京-下关-三汊河	热河南路/阅江楼/大桥南路/宝塔桥/建宁路/金陵小区
南京-下关-热河南路	三汊河/阅江楼/大桥南路/宝塔桥/建宁路/金陵小区
南京-下关-金陵小区	建宁路/宝塔桥/大桥南路/阅江楼/五塘/幕府山
南京-下关-小市	幕府山/五塘/建宁路/金陵小区/大桥南路/宝塔桥
南京-下关-幕府山	五塘/小市/建宁路/金陵小区/大桥南路/宝塔桥
南京-下关-阅江楼	大桥南路/宝塔桥/热河南路/金陵小区/建宁路/三汊河
南京-江宁-天元东路	上坊/竹山路/方山/金箔路/东山/文靖路
南京-江宁-岔路口	上元大街/东山/金箔路/科学园/胜太路/双龙大道
南京-江宁-将军大道	东善桥/秣陵/双龙大道/百家湖/胜太路/竹山路
南京-江宁-东善桥	将军大道/百家湖/胜太路/双龙大道/秣陵/科学园
南京-江宁-开发区	岔路口/百家湖/胜太路/双龙大道/东善桥/上元大街
南京-江宁-双龙大道	胜太路/百家湖/科学园/上元大街/金箔路/竹山路
南京-江宁-竹山路	科学园/金箔路/方山/东山/上元大街/天元东路
南京-江宁-东山	金箔路/上元大街/科学园/竹山路/天元东路/双龙大道
南京-江宁-上元大街	东山/金箔路/科学园/竹山路/双龙大道/胜太路
南京-江宁-秣陵	方山/将军大道/禄口/竹山路/双龙大道/科学园
南京-江宁-胜太路	百家湖/双龙大道/上元大街/科学园/金箔路/东山
南京-江宁-百家湖	胜太路/双龙大道/上元大街/科学园/金箔路/将军大道
南京-江宁-汤山	麒麟门/淳化/文靖路/上坊/天元东路/方山
南京-江宁-麒麟门	文靖路/淳化/上坊/天元东路/岔路口/东山
南京-江宁-禄口	秣陵/方山/将军大道/竹山路/天元东路/科学园
南京-江宁-方山	竹山路/科学园/天元东路/金箔路/东山/上元大街
南京-江宁-金箔路	东山/上元大街/科学园/竹山路/双龙大道/天元东路
南京-江宁-淳化	文靖路/上坊/麒麟门/天元东路/方山/竹山路
南京-江宁-文靖路	上坊/天元东路/麒麟门/东山/金箔路/上元大街
南京-江宁-上坊	天元东路/文靖路/东山/金箔路/竹山路/科学园
南京-江宁-科学园	金箔路/上元大街/东山/竹山路/双龙大道/方山
南京-浦口-南浦路	桥北/沿江/泰山/浦珠路/盘城/顶山
南京-浦口-江浦	顶山/浦珠路/泰山/桥北/沿江/盘城
南京-浦口-顶山	浦珠路/泰山/桥北/沿江/盘城/南浦路
南京-浦口-高新区	南浦路/桥北/泰山/沿江/浦珠路/盘城
南京-浦口-盘城	沿江/泰山/桥北/南浦路/浦珠路/顶山
南京-浦口-泰山	桥北/沿江/浦珠路/南浦路/盘城/顶山
南京-浦口-浦珠路	桥北/泰山/顶山/沿江/南浦路/盘城
南京-浦口-桥北	泰山/沿江/浦珠路/南浦路/顶山/盘城
南京-浦口-沿江	泰山/桥北/盘城/南浦路/浦珠路/顶山
南京-白下-建康路	太平南路/长白街/洪武路/常府街/大行宫/五老村
南京-白下-长白街	常府街/太平南路/五老村/大行宫/建康路/洪武路
南京-白下-升州路	朝天宫/止马营/中山南路/淮海路/洪武路/建康路
南京-白下-光华路	苜蓿园/月牙湖/中山门/御道街/瑞金路/大光路
南京-白下-洪武路	淮海路/中山南路/太平南路/建康路/大行宫/长白街
南京-白下-五老村	常府街/大行宫/长白街/太平南路/建康路/洪武路
南京-白下-中山门	月牙湖/苜蓿园/御道街/光华路/瑞金路/大光路
南京-白下-朝天宫	止马营/升州路/中山南路/淮海路/洪武路/太平南路
南京-白下-瑞金路	大光路/御道街/常府街/五老村/月牙湖/长白街
南京-白下-太平南路	长白街/建康路/大行宫/洪武路/常府街/五老村
南京-白下-大行宫	五老村/太平南路/长白街/常府街/洪武路/建康路
南京-白下-止马营	朝天宫/升州路/中山南路/淮海路/洪武路/太平南路
南京-白下-御道街	瑞金路/大光路/月牙湖/中山门/苜蓿园/常府街
南京-白下-苜蓿园	月牙湖/中山门/光华路/御道街/瑞金路/大光路
南京-白下-淮海路	洪武路/中山南路/太平南路/朝天宫/升州路/建康路
南京-白下-月牙湖	中山门/苜蓿园/御道街/光华路/瑞金路/大光路
南京-白下-大光路	瑞金路/御道街/常府街/五老村/长白街/大行宫
南京-白下-常府街	五老村/长白街/大行宫/太平南路/建康路/大光路
南京-白下-中山南路	淮海路/洪武路/朝天宫/升州路/太平南路/建康路
南京-高淳-阳江	砖墙/淳城/定埠/淳溪/古柏/固城
南京-高淳-桠溪	东坝/漆桥/固城/古柏/淳溪/定埠
南京-高淳-砖墙	阳江/淳城/定埠/淳溪/古柏/固城
南京-高淳-固城	漆桥/古柏/东坝/淳溪/定埠/淳城
南京-高淳-古柏	淳溪/定埠/淳城/固城/漆桥/砖墙
南京-高淳-淳溪	定埠/淳城/古柏/砖墙/阳江/固城
南京-高淳-东坝	漆桥/固城/桠溪/古柏/淳溪/定埠
南京-高淳-定埠	淳溪/淳城/古柏/砖墙/阳江/固城
南京-高淳-漆桥	固城/古柏/东坝/淳溪/定埠/淳城
南京-高淳-淳城	定埠/淳溪/砖墙/阳江/古柏/固城
南京-六合-西厂门	山潘/葛塘/卸甲甸/长芦/龙池/雄州
南京-六合-卸甲甸	西厂门/山潘/葛塘/长芦/龙池/雄州
南京-六合-山潘	西厂门/葛塘/卸甲甸/长芦/龙池/雄州
南京-六合-长芦	龙池/山潘/西厂门/葛塘/卸甲甸/雄州
南京-六合-龙池	长芦/雄州/山潘/葛塘/西厂门/卸甲甸
南京-六合-葛塘	西厂门/山潘/卸甲甸/长芦/龙池/雄州
南京-六合-雄州	龙池/长芦/山潘/西厂门/葛塘/卸甲甸
南京-玄武-长江路	丹凤街/北京东路/珠江路/梅园/兰园/玄武门
南京-玄武-玄武湖	玄武门/北京东路/兰园/丹凤街/珠江路/长江路
南京-玄武-北京东路	兰园/珠江路/梅园/玄武湖/长江路/丹凤街
南京-玄武-后宰门	板仓/锁金村/梅园/珠江路/兰园/樱驼花园
南京-玄武-樱驼花园	月苑/新街口/板仓/锁金村/后宰门/卫岗
南京-玄武-珠江路	梅园/兰园/北京东路/长江路/玄武湖/丹凤街
南京-玄武-卫岗	孝陵卫/后宰门/樱驼花园/板仓/锁金村/月苑
南京-玄武-玄武门	玄武湖/丹凤街/北京东路/长江路/兰园/珠江路
南京-玄武-丹凤街	长江路/玄武门/北京东路/玄武湖/珠江路/兰园
南京-玄武-孝陵卫	卫岗/樱驼花园/后宰门/板仓/月苑/锁金村
南京-玄武-新街口	月苑/樱驼花园/锁金村/板仓/红山/后宰门
南京-玄武-红山	锁金村/玄武湖/板仓/月苑/兰园/新街口
南京-玄武-板仓	锁金村/后宰门/樱驼花园/月苑/红山/新街口
南京-玄武-月苑	新街口/樱驼花园/锁金村/板仓/红山/后宰门
南京-玄武-兰园	北京东路/珠江路/梅园/玄武湖/长江路/丹凤街
南京-玄武-梅园	珠江路/兰园/北京东路/长江路/丹凤街/玄武湖
南京-玄武-锁金村	板仓/后宰门/红山/樱驼花园/月苑/兰园
南京-建邺-滨湖	湖西街/应天西路/茶南/南苑/江东门/南湖
南京-建邺-南湖	长虹路/南苑/水西门/滨湖/应天西路/湖西街
南京-建邺-南苑	南湖/滨湖/应天西路/长虹路/湖西街/茶南
南京-建邺-双闸	奥体/兴隆/沙洲/江心洲/白鹭花园/江东门
南京-建邺-水西门	长虹路/南湖/南苑/滨湖/应天西路/湖西街
南京-建邺-兴隆	奥体/白鹭花园/双闸/江东门/沙洲/茶南
南京-建邺-应天西路	滨湖/湖西街/茶南/南苑/江东门/白鹭花园
南京-建邺-奥体	兴隆/双闸/江心洲/白鹭花园/沙洲/江东门
南京-建邺-沙洲	应天西路/兴隆/湖西街/滨湖/双闸/白鹭花园
南京-建邺-茶南	湖西街/江东门/滨湖/应天西路/白鹭花园/南苑
南京-建邺-白鹭花园	江东门/茶南/湖西街/滨湖/应天西路/兴隆
南京-建邺-长虹路	南湖/水西门/南苑/滨湖/应天西路/湖西街
南京-建邺-江心洲	奥体/双闸/兴隆/白鹭花园/沙洲/江东门
南京-建邺-江东门	白鹭花园/茶南/湖西街/滨湖/应天西路/南苑
南京-建邺-湖西街	滨湖/茶南/应天西路/江东门/南苑/白鹭花园
南京-鼓楼-湖南路	许府巷/中央门/上海路/华侨路/宁海路/三牌楼
南京-鼓楼-上海路	宁海路/华侨路/广州路/北京西路/汉中门/湖南路
南京-鼓楼-龙江	江东/定淮门/凤凰西街/虎踞路/莫愁/挹江门
南京-鼓楼-广州路	宁海路/汉中门/北京西路/上海路/水佐岗/华侨路
南京-鼓楼-华侨路	上海路/湖南路/宁海路/广州路/汉中门/北京西路
南京-鼓楼-江东	龙江/定淮门/凤凰西街/挹江门/虎踞路/莫愁
南京-鼓楼-中央门	许府巷/湖南路/三牌楼/上海路/宁海路/华侨路
南京-鼓楼-北京西路	宁海路/水佐岗/广州路/汉中门/三牌楼/上海路
南京-鼓楼-虎踞路	莫愁/凤凰西街/汉中门/水佐岗/北京西路/龙江
南京-鼓楼-挹江门	定淮门/江东/龙江/福建路/虎踞路/水佐岗
南京-鼓楼-福建路	三牌楼/水佐岗/北京西路/宁海路/许府巷/虎踞路
南京-鼓楼-凤凰西街	莫愁/龙江/虎踞路/江东/定淮门/汉中门
南京-鼓楼-定淮门	江东/龙江/挹江门/凤凰西街/虎踞路/莫愁
南京-鼓楼-莫愁	凤凰西街/虎踞路/汉中门/龙江/江东/广州路
南京-鼓楼-汉中门	广州路/北京西路/宁海路/上海路/虎踞路/莫愁
南京-鼓楼-宁海路	北京西路/广州路/上海路/汉中门/水佐岗/三牌楼
南京-鼓楼-许府巷	中央门/湖南路/三牌楼/宁海路/福建路/上海路
南京-鼓楼-三牌楼	水佐岗/福建路/北京西路/宁海路/许府巷/广州路
南京-鼓楼-水佐岗	北京西路/三牌楼/福建路/宁海路/虎踞路/广州路
南京-栖霞-晓庄	迈皋桥/万寿/八卦洲/尧化/燕子矶/马群
南京-栖霞-万寿	晓庄/迈皋桥/八卦洲/尧化/燕子矶/马群
南京-栖霞-马群	仙林/燕子矶/尧化/栖霞/万寿/晓庄
南京-栖霞-龙潭	栖霞/靖安/仙林/燕子矶/马群/尧化
南京-栖霞-八卦洲	晓庄/万寿/迈皋桥/尧化/燕子矶/马群
南京-栖霞-燕子矶	仙林/马群/栖霞/尧化/万寿/八卦洲
南京-栖霞-迈皋桥	晓庄/万寿/八卦洲/尧化/马群/燕子矶
南京-栖霞-靖安	龙潭/栖霞/仙林/燕子矶/马群/尧化
南京-栖霞-仙林	燕子矶/马群/栖霞/尧化/万寿/八卦洲
南京-栖霞-栖霞	仙林/燕子矶/马群/龙潭/尧化/万寿
南京-栖霞-尧化	万寿/燕子矶/马群/仙林/晓庄/八卦洲
南京-秦淮-长乐路	夫子庙/中华门/双塘/洪家园/秦虹/红花
南京-秦淮-红花	洪家园/秦虹/大明路/长乐路/夫子庙/中华门
南京-秦淮-来凤	双塘/集庆门/中华门/夫子庙/长乐路/洪家园
南京-秦淮-大明路	秦虹/红花/洪家园/长乐路/夫子庙/中华门
南京-秦淮-夫子庙	长乐路/中华门/双塘/来凤/秦虹/洪家园
南京-秦淮-双塘	来凤/集庆门/中华门/夫子庙/长乐路/洪家园
南京-秦淮-秦虹	红花/大明路/洪家园/长乐路/夫子庙/中华门
南京-秦淮-集庆门	来凤/双塘/中华门/夫子庙/长乐路/洪家园
南京-秦淮-洪家园	红花/秦虹/大明路/长乐路/夫子庙/中华门
南京-秦淮-中华门	夫子庙/长乐路/双塘/来凤/集庆门/洪家园
南京-雨花台-梅山	西善桥/小行/铁心桥/安德门/板桥/赛虹桥
南京-雨花台-雨花新村	能仁里/安德门/赛虹桥/铁心桥/小行/宁南
南京-雨花台-赛虹桥	能仁里/安德门/雨花新村/铁心桥/小行/西善桥
南京-雨花台-板桥	梅山/西善桥/小行/铁心桥/安德门/赛虹桥
南京-雨花台-小行	安德门/赛虹桥/铁心桥/能仁里/西善桥/雨花新村
南京-雨花台-安德门	铁心桥/能仁里/赛虹桥/雨花新村/小行/宁南
南京-雨花台-铁心桥	安德门/能仁里/赛虹桥/雨花新村/小行/宁南
南京-雨花台-西善桥	梅山/小行/铁心桥/安德门/赛虹桥/能仁里
南京-雨花台-能仁里	雨花新村/赛虹桥/安德门/铁心桥/小行/宁南
南京-雨花台-宁南	雨花新村/能仁里/铁心桥/安德门/赛虹桥/小行
南京-溧水-石湫	柘塘/洪蓝/溧水开发区/和凤/溧水县农场/永阳
南京-溧水-晶桥	永阳/和凤/溧水县农场/溧水开发区/洪蓝/东屏
南京-溧水-溧水开发区	溧水县农场/永阳/洪蓝/晶桥/东屏/和凤
南京-溧水-白马	东屏/晶桥/永阳/溧水县农场/溧水开发区/和凤
南京-溧水-洪蓝	溧水开发区/溧水县农场/和凤/永阳/石湫/晶桥
南京-溧水-和凤	洪蓝/晶桥/溧水开发区/永阳/溧水县农场/石湫
南京-溧水-东屏	永阳/溧水县农场/白马/晶桥/溧水开发区/洪蓝
南京-溧水-柘塘	石湫/洪蓝/溧水开发区/溧水县农场/永阳/和凤
南京-溧水-溧水县农场	永阳/溧水开发区/洪蓝/晶桥/东屏/和凤
南京-溧水-永阳	溧水县农场/溧水开发区/洪蓝/晶桥/东屏/和凤
成都-大邑-安仁	上安/苏家/董场/三岔/蔡场/青霞
成都-大邑-苏家	三岔/晋原/上安/青霞/安仁/王泗
成都-大邑-沙渠	韩场/蔡场/董场/安仁/上安/苏家
成都-大邑-青霞	晋原/三岔/苏家/王泗/安仁/上安
成都-大邑-新场	悦来/王泗/斜源/晋原/三岔/青霞
成都-大邑-悦来	新场/王泗/晋原/青霞/三岔/斜源
成都-大邑-上安	安仁/苏家/三岔/董场/晋原/青霞
成都-大邑-王泗	悦来/新场/晋原/三岔/青霞/苏家
成都-大邑-晋原	青霞/三岔/苏家/王泗/悦来/上安
成都-大邑-韩场	蔡场/董场/沙渠/安仁/上安/苏家
成都-大邑-蔡场	董场/韩场/沙渠/安仁/上安/苏家
成都-大邑-斜源	出江/新场/花水湾/悦来/西岭/王泗
成都-大邑-花水湾	西岭/出江/斜源/新场/悦来/王泗
成都-大邑-西岭	花水湾/出江/斜源/新场/悦来/王泗
成都-大邑-出江	花水湾/斜源/西岭/新场/悦来/王泗
成都-大邑-三岔	晋原/苏家/青霞/王泗/上安/安仁
成都-大邑-董场	蔡场/韩场/沙渠/安仁/上安/苏家
成都-郫县-团结	犀浦/红光/安靖/古城/三道堰/郫筒
成都-郫县-唐昌	安德/友爱/新民场/德源/唐元/郫筒
成都-郫县-古城	三道堰/红光/唐元/郫筒/犀浦/团结
成都-郫县-花园	友爱/安德/唐昌/德源/新民场/唐元
成都-郫县-新民场	唐元/郫筒/德源/唐昌/三道堰/安德
成都-郫县-三道堰	古城/红光/唐元/郫筒/新民场/犀浦
成都-郫县-友爱	安德/唐昌/花园/德源/新民场/郫筒
成都-郫县-郫筒	唐元/新民场/德源/三道堰/古城/红光
成都-郫县-安靖	团结/犀浦/红光/古城/三道堰/郫筒
成都-郫县-唐元	新民场/郫筒/三道堰/德源/古城/唐昌
成都-郫县-德源	新民场/郫筒/唐元/唐昌/安德/友爱
成都-郫县-红光	犀浦/古城/三道堰/团结/郫筒/唐元
成都-郫县-犀浦	团结/红光/安靖/古城/三道堰/郫筒
成都-郫县-安德	友爱/唐昌/德源/花园/新民场/唐元
成都-温江-南熏大道	万春/金马/温江城区/天府/永盛/和盛
成都-温江-永盛	和盛/寿安/南熏大道/金马/万春/温江城区
成都-温江-天府	光华大道/温江城区/公平/万春/南熏大道/金马
成都-温江-公平	光华大道/天府/永宁/温江城区/万春/南熏大道
成都-温江-金马	南熏大道/万春/温江城区/永盛/和盛/天府
成都-温江-和盛	永盛/寿安/南熏大道/金马/万春/温江城区
成都-温江-永宁	公平/光华大道/天府/温江城区/万春/南熏大道
成都-温江-寿安	和盛/永盛/南熏大道/金马/万春/温江城区
成都-温江-温江城区	万春/南熏大道/天府/金马/光华大道/公平
成都-温江-光华大道	公平/天府/温江城区/永宁/万春/南熏大道
成都-温江-万春	温江城区/南熏大道/天府/金马/光华大道/永盛
成都-彭州-丹景山	新兴/通济/隆丰/丽春/桂花/龙门山
成都-彭州-隆丰	丽春/新兴/丹景山/通济/白鹿/天彭
成都-彭州-军乐	敖平/致和/葛仙山/红岩/升平/天彭
成都-彭州-升平	九尺/红岩/敖平/军乐/致和/葛仙山
成都-彭州-龙门山	磁峰/小鱼洞/通济/桂花/丹景山/新兴
成都-彭州-致和	军乐/敖平/升平/天彭/葛仙山/红岩
成都-彭州-葛仙山	军乐/敖平/天彭/白鹿/红岩/致和
成都-彭州-小鱼洞	磁峰/龙门山/桂花/通济/丹景山/新兴
成都-彭州-九尺	升平/红岩/敖平/军乐/致和/三界
成都-彭州-桂花	磁峰/龙门山/小鱼洞/通济/丹景山/新兴
成都-彭州-红岩	敖平/升平/军乐/九尺/葛仙山/致和
成都-彭州-通济	新兴/丹景山/龙门山/隆丰/桂花/磁峰
成都-彭州-磁峰	桂花/小鱼洞/龙门山/通济/丹景山/新兴
成都-彭州-餮	三界/九尺/升平/红岩/敖平/致和
成都-彭州-白鹿	葛仙山/隆丰/天彭/新兴/丽春/军乐
成都-彭州-敖平	军乐/红岩/葛仙山/升平/致和/九尺
成都-彭州-丽春	隆丰/丹景山/新兴/通济/天彭/白鹿
成都-彭州-新兴	丹景山/通济/隆丰/丽春/桂花/龙门山
成都-彭州-天彭	葛仙山/致和/军乐/白鹿/敖平/隆丰
成都-彭州-三界	餮/九尺/升平/红岩/敖平/军乐
成都-金牛-蜀汉路	黄忠/茶店子/营门口/抚琴/金泉/交大路
成都-金牛-火车北站	人民北路/荷花池/五块石/梁家巷/凤凰山/九里堤
成都-金牛-黄忠	蜀汉路/茶店子/金泉/营门口/抚琴/交大路
成都-金牛-茶店子	蜀汉路/营门口/抚琴/黄忠/交大路/花牌坊
成都-金牛-抚琴	营门口/交大路/花牌坊/茶店子/西华/西安路
成都-金牛-花牌坊	西安路/西华/沙湾/交大路/抚琴/营门口
成都-金牛-西华	沙湾/花牌坊/交大路/西安路/沙河源/九里堤
成都-金牛-马鞍路	天回/李家沱/凤凰山/梁家巷/荷花池/火车北站
成都-金牛-西安路	花牌坊/沙湾/西华/交大路/九里堤/抚琴
成都-金牛-梁家巷	荷花池/李家沱/火车北站/凤凰山/人民北路/五块石
成都-金牛-金泉	黄忠/蜀汉路/茶店子/营门口/抚琴/交大路
成都-金牛-九里堤	沙湾/五块石/沙河源/西华/西安路/花牌坊
成都-金牛-沙湾	西华/花牌坊/西安路/沙河源/九里堤/交大路
成都-金牛-荷花池	火车北站/梁家巷/人民北路/凤凰山/李家沱/五块石
成都-金牛-交大路	西华/营门口/花牌坊/沙湾/抚琴/西安路
成都-金牛-凤凰山	荷花池/梁家巷/火车北站/李家沱/人民北路/五块石
成都-金牛-李家沱	梁家巷/荷花池/凤凰山/火车北站/人民北路/五块石
成都-金牛-营门口	抚琴/交大路/茶店子/花牌坊/西华/西安路
成都-金牛-人民北路	火车北站/荷花池/五块石/梁家巷/凤凰山/九里堤
成都-金牛-五块石	九里堤/人民北路/火车北站/沙河源/荷花池/沙湾
成都-金牛-沙河源	沙湾/西华/九里堤/交大路/花牌坊/五块石
成都-金牛-天回	马鞍路/李家沱/凤凰山/梁家巷/荷花池/火车北站
成都-金堂-赵家	淮口/白果/福兴/高板/三溪/五凤
成都-金堂-金龙	隆盛/竹篙/三溪/福兴/高板/转龙
成都-金堂-隆盛	金龙/竹篙/三溪/高板/福兴/云合
成都-金堂-三星	赵镇/官仓/清江/五凤/白果/淮口
成都-金堂-赵镇	三星/官仓/清江/五凤/白果/淮口
成都-金堂-云合	竹篙/又新/广兴/转龙/隆盛/土桥
成都-金堂-淮口	白果/赵家/高板/三溪/福兴/五凤
成都-金堂-又新	广兴/转龙/云合/土桥/竹篙/隆盛
成都-金堂-三溪	福兴/高板/金龙/赵家/隆盛/淮口
成都-金堂-清江	官仓/赵镇/三星/五凤/白果/淮口
成都-金堂-高板	三溪/福兴/赵家/淮口/隆盛/金龙
成都-金堂-广兴	又新/转龙/云合/土桥/竹篙/隆盛
成都-金堂-土桥	又新/广兴/转龙/云合/竹篙/隆盛
成都-金堂-转龙	广兴/又新/竹篙/云合/土桥/隆盛
成都-金堂-白果	淮口/赵家/五凤/高板/三溪/三星
成都-金堂-福兴	三溪/高板/金龙/赵家/隆盛/淮口
成都-金堂-竹篙	云合/隆盛/转龙/金龙/又新/广兴
成都-金堂-官仓	赵镇/三星/清江/五凤/白果/淮口
成都-金堂-五凤	白果/三星/赵镇/淮口/官仓/赵家
成都-青白江-大弯	红阳
成都-青白江-红阳	大弯
成都-双流-正兴	华阳/煎茶/白家/籍田/文星/中和
成都-双流-白家	华阳/正兴/文星/煎茶/公兴/籍田
成都-双流-黄甲	航空港/东升/胜利/九江/公兴/永安
成都-双流-新兴	白沙/万安/永兴/合江/兴隆/三星
成都-双流-黄水	彭镇/胜利/九江/东升/金桥/黄甲
成都-双流-白沙	新兴/永兴/合江/三星/万安/兴隆
成都-双流-永安	公兴/黄龙溪/文星/黄甲/籍田/航空港
成都-双流-九江	东升/胜利/黄甲/黄水/彭镇/航空港
成都-双流-中和	万安/兴隆/华阳/正兴/新兴/白家
成都-双流-煎茶	正兴/华阳/籍田/白家/兴隆/中和
成都-双流-合江	三星/白沙/永兴/太平/新兴/大林
成都-双流-大林	永兴/三星/兴隆/万安/白沙/合江
成都-双流-太平	合江/白沙/三星/新兴/永兴/大林
成都-双流-黄龙溪	永安/公兴/黄甲/籍田/文星/航空港
成都-双流-文星	公兴/航空港/永安/白家/黄甲/正兴
成都-双流-东升	九江/胜利/黄甲/航空港/黄水/彭镇
成都-双流-永兴	三星/大林/白沙/合江/新兴/兴隆
成都-双流-航空港	黄甲/公兴/文星/东升/永安/九江
成都-双流-万安	兴隆/中和/新兴/白沙/永兴/大林
成都-双流-籍田	煎茶/正兴/永安/黄龙溪/公兴/白家
成都-双流-彭镇	黄水/胜利/九江/金桥/东升/黄甲
成都-双流-华阳	正兴/白家/煎茶/中和/兴隆/万安
成都-双流-胜利	东升/黄水/九江/彭镇/黄甲/航空港
成都-双流-金桥	彭镇/黄水/胜利/九江/东升/黄甲
成都-双流-兴隆	万安/中和/大林/永兴/白沙/新兴
成都-双流-三星	永兴/合江/大林/白沙/新兴/兴隆
成都-双流-公兴	文星/永安/航空港/黄甲/黄龙溪/白家
成都-成华-八里庄	八里小区/青龙/建设路/新鸿路/圣灯/双桥子
成都-成华-万年场	圣灯/双桥子/新鸿路/八里小区/八里庄/跳蹬河
成都-成华-双桥子	新鸿路/新华公园/双水碾/建设路/万年场/八里小区
成都-成华-新鸿路	新华公园/建设路/双桥子/双水碾/八里小区/八里庄
成都-成华-青龙	八里小区/八里庄/建设路/新鸿路/新华公园/驷马桥
成都-成华-龙潭	五桂桥/二仙桥/跳蹬河/圣灯/万年场/八里庄
成都-成华-双水碾	新华公园/新鸿路/双桥子/建设路/猛追湾/玉双路
成都-成华-五桂桥	跳蹬河/二仙桥/万年场/圣灯/双桥子/八里庄
成都-成华-建设路	新鸿路/新华公园/双桥子/八里小区/双水碾/八里庄
成都-成华-府青路	猛追湾/玉双路/驷马桥/建设路/双水碾/新华公园
成都-成华-跳蹬河	二仙桥/圣灯/五桂桥/万年场/八里庄/八里小区
成都-成华-二仙桥	跳蹬河/圣灯/五桂桥/万年场/八里庄/八里小区
成都-成华-新华公园	新鸿路/双水碾/建设路/双桥子/八里小区/八里庄
成都-成华-八里小区	八里庄/青龙/建设路/新鸿路/圣灯/双桥子
成都-成华-圣灯	万年场/八里庄/八里小区/跳蹬河/二仙桥/双桥子
成都-成华-玉双路	猛追湾/府青路/双水碾/驷马桥/新华公园/建设路
成都-成华-驷马桥	府青路/猛追湾/玉双路/青龙/建设路/新华公园
成都-成华-猛追湾	玉双路/府青路/驷马桥/双水碾/建设路/新华公园
成都-锦江-书院街	红星路/合江亭/水碾河/春熙路/九眼桥/新南门
成都-锦江-水碾河	九眼桥/书院街/合江亭/红星路/莲桂路/龙舟路
成都-锦江-柳江	龙舟路/莲桂路/牛沙路/东光/九眼桥/海椒市
成都-锦江-沙河	狮子山/双桂路/成龙路/牛市口/东光/海椒市
成都-锦江-双桂路	沙河/狮子山/成龙路/牛市口/东光/海椒市
成都-锦江-成龙路	双桂路/沙河/狮子山/牛市口/东光/海椒市
成都-锦江-川师	成仁路/盐市口/新南门/合江亭/春熙路/柳江
成都-锦江-龙舟路	牛沙路/莲桂路/海椒市/九眼桥/柳江/东光
成都-锦江-牛市口	海椒市/东光/牛沙路/成龙路/龙舟路/双桂路
成都-锦江-牛王庙	三圣/狮子山/沙河/双桂路/成龙路/牛市口
成都-锦江-春熙路	新南门/红星路/合江亭/书院街/盐市口/水碾河
成都-锦江-新南门	春熙路/盐市口/合江亭/红星路/书院街/水碾河
成都-锦江-狮子山	沙河/双桂路/成龙路/牛市口/东光/三圣
成都-锦江-东光	海椒市/牛市口/龙舟路/牛沙路/莲桂路/柳江
成都-锦江-牛沙路	龙舟路/莲桂路/海椒市/东光/九眼桥/柳江
成都-锦江-九眼桥	水碾河/莲桂路/龙舟路/牛沙路/书院街/合江亭
成都-锦江-三圣	牛王庙/狮子山/沙河/双桂路/成龙路/牛市口
成都-锦江-红星路	书院街/合江亭/春熙路/水碾河/新南门/九眼桥
成都-锦江-合江亭	书院街/红星路/春熙路/水碾河/新南门/九眼桥
成都-锦江-成仁路	川师/盐市口/新南门/合江亭/春熙路/柳江
成都-锦江-莲桂路	龙舟路/牛沙路/九眼桥/海椒市/水碾河/柳江
成都-锦江-盐市口	新南门/春熙路/红星路/合江亭/书院街/水碾河
成都-锦江-海椒市	牛沙路/牛市口/龙舟路/莲桂路/东光/九眼桥
成都-锦江-滨江路	川师/成仁路/盐市口/新南门/春熙路/合江亭
成都-都江堰-石羊	翠月湖/柳街/中兴/幸福/安龙/聚源
成都-都江堰-大观	青城山/玉堂/安龙/紫坪铺/中兴/龙池
成都-都江堰-灌口	幸福/中兴/翠月湖/玉堂/石羊/聚源
成都-都江堰-天马	崇义/胥家/蒲阳/聚源/柳街/石羊
成都-都江堰-安龙	翠月湖/中兴/石羊/大观/玉堂/幸福
成都-都江堰-中兴	翠月湖/幸福/灌口/玉堂/石羊/安龙
成都-都江堰-翠月湖	中兴/石羊/幸福/灌口/安龙/柳街
成都-都江堰-紫坪铺	玉堂/青城山/大观/龙池/中兴/灌口
成都-都江堰-胥家	蒲阳/聚源/崇义/柳街/幸福/石羊
成都-都江堰-龙池	青城山/紫坪铺/大观/玉堂/中兴/安龙
成都-都江堰-聚源	胥家/蒲阳/石羊/柳街/幸福/翠月湖
成都-都江堰-柳街	石羊/翠月湖/聚源/中兴/安龙/幸福
成都-都江堰-蒲阳	胥家/聚源/幸福/灌口/崇义/翠月湖
成都-都江堰-崇义	天马/胥家/聚源/蒲阳/柳街/石羊
成都-都江堰-玉堂	紫坪铺/中兴/灌口/幸福/翠月湖/大观
成都-都江堰-青城山	大观/紫坪铺/龙池/玉堂/安龙/中兴
成都-都江堰-幸福	灌口/中兴/翠月湖/玉堂/石羊/聚源
成都-国家高新技术产业开发区-创业路	神仙树/紫荆/芳草街/南延线
成都-国家高新技术产业开发区-南延线	芳草街/紫荆/神仙树/创业路
成都-国家高新技术产业开发区-芳草街	紫荆/神仙树/创业路/南延线
成都-国家高新技术产业开发区-紫荆	芳草街/神仙树/创业路/南延线
成都-国家高新技术产业开发区-神仙树	紫荆/芳草街/创业路/南延线
成都-新津-普兴	金华/花源/花桥/邓双/兴义/五津
成都-新津-金华	普兴/花源/花桥/邓双/五津/兴义
成都-新津-花桥	邓双/花源/金华/兴义/五津/普兴
成都-新津-五津	兴义/新平/邓双/永商/花桥/安西
成都-新津-方兴	安西/新平/永商/五津/兴义/邓双
成都-新津-兴义	五津/邓双/新平/永商/花桥/安西
成都-新津-新平	永商/五津/兴义/安西/邓双/方兴
成都-新津-邓双	花桥/五津/兴义/新平/永商/金华
成都-新津-安西	方兴/新平/永商/五津/兴义/邓双
成都-新津-花源	普兴/金华/花桥/邓双/兴义/五津
成都-新津-永商	新平/五津/兴义/安西/邓双/方兴
成都-新都-清流	龙桥/斑竹园/大丰/新民/石板滩/马家
成都-新都-马家	三河/军屯/新繁/新民/新都/大丰
成都-新都-新民	马家/斑竹园/三河/大丰/军屯/清流
成都-新都-龙桥	清流/斑竹园/石板滩/大丰/新民/马家
成都-新都-三河	马家/新繁/新都/军屯/新民/大丰
成都-新都-斑竹园	大丰/龙桥/清流/新民/石板滩/马家
成都-新都-大丰	斑竹园/石板滩/龙桥/新民/清流/马家
成都-新都-石板滩	大丰/龙桥/斑竹园/清流/新民/三河
成都-新都-军屯	新繁/新都/马家/三河/新民/木兰
成都-新都-新繁	新都/军屯/三河/马家/木兰/新民
成都-新都-新都	新繁/军屯/三河/马家/木兰/泰兴
成都-新都-木兰	泰兴/新都/新繁/军屯/三河/马家
成都-新都-泰兴	木兰/新都/新繁/军屯/三河/马家
成都-武侯-跳伞塔	小天竺/火车南站/磨子桥/航空路/桂溪/桐梓林
成都-武侯-小天竺	跳伞塔/桐梓林/火车南站/玉林/浆洗街/磨子桥
成都-武侯-火车南站	跳伞塔/小天竺/桐梓林/航空路/桂溪/磨子桥
成都-武侯-致民路	望江路/桂溪/磨子桥/航空路/跳伞塔/火车南站
成都-武侯-簇桥	机投镇/五大花园/清水河/外双楠/红牌楼/内双楠
成都-武侯-内双楠	红牌楼/外双楠/石羊/高升桥/肖家河/武侯祠大街
成都-武侯-石羊	肖家河/高升桥/红牌楼/内双楠/外双楠/武侯祠大街
成都-武侯-望江路	致民路/桂溪/磨子桥/航空路/跳伞塔/火车南站
成都-武侯-航空路	桂溪/磨子桥/跳伞塔/火车南站/小天竺/致民路
成都-武侯-武侯祠大街	洗面桥/肖家河/高升桥/浆洗街/玉林/桐梓林
成都-武侯-桂溪	航空路/磨子桥/跳伞塔/火车南站/致民路/小天竺
成都-武侯-清水河	机投镇/五大花园/簇桥/外双楠/内双楠/红牌楼
成都-武侯-磨子桥	桂溪/航空路/跳伞塔/火车南站/小天竺/致民路
成都-武侯-高升桥	肖家河/武侯祠大街/石羊/洗面桥/内双楠/浆洗街
成都-武侯-五大花园	机投镇/簇桥/清水河/外双楠/内双楠/红牌楼
成都-武侯-玉林	桐梓林/浆洗街/洗面桥/小天竺/武侯祠大街/火车南站
成都-武侯-桐梓林	玉林/小天竺/火车南站/浆洗街/跳伞塔/洗面桥
成都-武侯-金花镇	望江路/致民路/磨子桥/桂溪/航空路/跳伞塔
成都-武侯-红牌楼	内双楠/外双楠/石羊/高升桥/肖家河/武侯祠大街
成都-武侯-肖家河	高升桥/武侯祠大街/石羊/洗面桥/浆洗街/玉林
成都-武侯-洗面桥	浆洗街/武侯祠大街/玉林/桐梓林/肖家河/高升桥
成都-武侯-浆洗街	洗面桥/玉林/武侯祠大街/桐梓林/小天竺/跳伞塔
成都-武侯-外双楠	内双楠/红牌楼/石羊/高升桥/肖家河/五大花园
成都-武侯-机投镇	簇桥/五大花园/清水河/外双楠/红牌楼/内双楠
成都-龙泉驿-大面	龙泉/同安/十陵/洪河
成都-龙泉驿-洪河	十陵/大面/龙泉/同安
成都-龙泉驿-同安	龙泉/大面/十陵/洪河
成都-龙泉驿-十陵	洪河/大面/龙泉/同安
成都-龙泉驿-龙泉	大面/同安/十陵/洪河
成都-青羊-苏坡	贝森/西南财大/光华/府南新区/金沙/浣花小区
成都-青羊-光华	西南财大/金沙/府南新区/浣花小区/草堂/贝森
成都-青羊-贝森	西南财大/光华/苏坡/府南新区/金沙/浣花小区
成都-青羊-太升路	草市街/天府广场/长顺街/八宝街/东坡/人民公园
成都-青羊-白果林	顺城街/文家/苏坡/贝森/西南财大/光华
成都-青羊-长顺街	天府广场/八宝街/东坡/人民公园/新华西路/草市街
成都-青羊-新华西路	东坡/人民公园/八宝街/长顺街/中医附院/黄田坝
成都-青羊-八宝街	东坡/长顺街/天府广场/人民公园/新华西路/草市街
成都-青羊-黄田坝	中医附院/青羊小区/百花中心站/新华西路/人民公园/草堂
成都-青羊-西南财大	光华/金沙/府南新区/浣花小区/草堂/贝森
成都-青羊-草堂	浣花小区/金沙/府南新区/百花中心站/光华/青羊小区
成都-青羊-青羊小区	中医附院/黄田坝/百花中心站/新华西路/草堂/人民公园
成都-青羊-东坡	八宝街/人民公园/长顺街/新华西路/天府广场/黄田坝
成都-青羊-浣花小区	金沙/光华/草堂/府南新区/西南财大/百花中心站
成都-青羊-天府广场	长顺街/八宝街/东坡/人民公园/新华西路/草市街
成都-青羊-金沙	府南新区/光华/浣花小区/西南财大/草堂/百花中心站
成都-青羊-府南新区	金沙/光华/西南财大/浣花小区/草堂/百花中心站
成都-青羊-中医附院	青羊小区/黄田坝/百花中心站/新华西路/人民公园/草堂
成都-青羊-文家	顺城街/苏坡/贝森/西南财大/光华/府南新区
成都-青羊-百花中心站	黄田坝/中医附院/青羊小区/草堂/新华西路/人民公园
成都-青羊-草市街	太升路/天府广场/长顺街/八宝街/东坡/人民公园
成都-青羊-人民公园	东坡/八宝街/新华西路/长顺街/天府广场/黄田坝
成都-青羊-顺城街	文家/苏坡/贝森/西南财大/光华/府南新区
成都-崇州-隆兴	白头/道明/桤泉/元通/王场/观胜
成都-崇州-三郎	怀远/街子/王场/道明/白头/万家
成都-崇州-梓潼	廖家/崇平/崇阳/观胜/羊马/大划
成都-崇州-怀远	三郎/街子/王场/道明/万家/白头
成都-崇州-万家	怀远/三郎/街子/王场/道明/白头
成都-崇州-廖家	梓潼/崇平/崇阳/观胜/羊马/大划
成都-崇州-大划	羊马/崇平/三江/江源/廖家/崇阳
成都-崇州-道明	白头/王场/元通/隆兴/街子/观胜
成都-崇州-王场	道明/白头/隆兴/元通/街子/三郎
成都-崇州-街子	三郎/怀远/王场/道明/元通/白头
成都-崇州-崇平	廖家/梓潼/崇阳/羊马/大划/观胜
成都-崇州-观胜	梓潼/崇阳/廖家/元通/桤泉/崇平
成都-崇州-元通	白头/道明/隆兴/观胜/王场/桤泉
成都-崇州-崇阳	廖家/崇平/桤泉/梓潼/观胜/大划
成都-崇州-桤泉	崇阳/隆兴/观胜/廖家/白头/元通
成都-崇州-白头	隆兴/道明/元通/王场/桤泉/观胜
成都-崇州-羊马	大划/崇平/江源/三江/廖家/梓潼
成都-崇州-江源	三江/羊马/大划/崇平/廖家/梓潼
成都-崇州-三江	江源/大划/羊马/崇平/廖家/崇阳
成都-邛崃-桑园	天台山/临邛/卧龙/宝林/前进/平乐
成都-邛崃-卧龙	天台山/桑园/临邛/宝林/平乐/前进
成都-邛崃-夹关	火井/高何/临济/水口/平乐/卧龙
成都-邛崃-天台山	临邛/桑园/宝林/卧龙/前进/固驿
成都-邛崃-临济	水口/平乐/火井/夹关/卧龙/高何
成都-邛崃-宝林	临邛/前进/天台山/桑园/固驿/卧龙
成都-邛崃-前进	宝林/固驿/临邛/天台山/桑园/高埂
成都-邛崃-羊安	回龙/牟礼/冉义/高埂/固驿/前进
成都-邛崃-临邛	天台山/桑园/宝林/卧龙/前进/固驿
成都-邛崃-水口	平乐/临济/火井/夹关/卧龙/高何
成都-邛崃-回龙	牟礼/羊安/冉义/高埂/固驿/前进
成都-邛崃-高埂	冉义/固驿/牟礼/回龙/羊安/前进
成都-邛崃-平乐	水口/临济/卧龙/火井/夹关/桑园
成都-邛崃-冉义	牟礼/高埂/羊安/回龙/固驿/前进
成都-邛崃-高何	夹关/火井/临济/水口/平乐/卧龙
成都-邛崃-固驿	高埂/前进/冉义/宝林/牟礼/回龙
成都-邛崃-牟礼	回龙/冉义/羊安/高埂/固驿/前进
成都-邛崃-火井	夹关/临济/水口/高何/平乐/卧龙
成都-蒲江-大塘	成佳/甘溪/大兴/朝阳湖/西来/鹤山
成都-蒲江-朝阳湖	大兴/鹤山/西来/成佳/大塘/甘溪
成都-蒲江-成佳	大塘/甘溪/大兴/朝阳湖/鹤山/西来
成都-蒲江-甘溪	大塘/成佳/大兴/朝阳湖/西来/鹤山
成都-蒲江-西来	鹤山/朝阳湖/大兴/寿安/大塘/成佳
成都-蒲江-大兴	朝阳湖/大塘/成佳/甘溪/西来/鹤山
成都-蒲江-寿安	鹤山/西来/朝阳湖/大兴/大塘/成佳
成都-蒲江-鹤山	西来/朝阳湖/大兴/寿安/大塘/成佳
长春-经开-临河街	中东大市场/世纪大街/东广场
长春-经开-世纪大街	中东大市场/临河街/东广场
长春-经开-东广场	临河街/中东大市场/世纪大街
长春-经开-中东大市场	世纪大街/临河街/东广场
长春-净月-净月大学城	枫叶路/彩宇大街
长春-净月-枫叶路	净月大学城/彩宇大街
长春-净月-彩宇大街	净月大学城/枫叶路
长春-高新-硅谷广场	光谷大街
长春-高新-光谷大街	硅谷广场
长春-南关区-长通路	东大桥/桃源/东天街/三道街/新春/大马路
长春-南关区-东天街	东大桥/桃源/长通路/三道街/全安/永吉
长春-南关区-文昌路	动植物公园/磐石/曙光路/岳阳街/体育场/平阳街
长春-南关区-民康路	四道街/树勋街/人民广场东/自强街/平治街/平阳街
长春-南关区-南关客运站	珲春街/南街/大经路/永吉/西四道街/通化路
长春-南关区-上海路	西五/三马路/自强街/平治街/人民广场东/新春
长春-南关区-南街	大经路/大马路/二马路/西四道街/南关客运站/三道街
长春-南关区-磐石	文昌路/鸿城/动植物公园/亚泰大街/体育场/净水路
长春-南关区-净水路	鸿城/卫星路/东岭南街/磐石/亚泰大街/南岭
长春-南关区-四道街	民康路/自强街/树勋街/平治街/人民广场东/平阳街
长春-南关区-树勋街	民康路/四道街/平阳街/曙光路/岳阳街/通化路
长春-南关区-体育场	亚泰大街/南岭/动植物公园/南关客运站/珲春街/永吉
长春-南关区-二马路	大马路/新春/南街/三马路/大经路/西四道街
长春-南关区-隆礼路	解放大路/岳阳街/树勋街/民康路/曙光路/文昌路
长春-南关区-鸿城	净水路/东岭南街/磐石/亚泰大街/卫星路/南岭
长春-南关区-东南湖大路	临河/自由大路/东岭街/东岭南街/东天街/南岭
长春-南关区-东岭南街	鸿城/亚泰大街/南岭/净水路/东岭街/体育场
长春-南关区-西五	新春/三马路/二马路/大马路/上海路/大经路
长春-南关区-永吉	全安/南关客运站/三道街/南街/南岭/体育场
长春-南关区-平治街	自强街/西四道街/四道街/人民广场东/民康路/大经路
长春-南关区-曙光路	平阳街/通化路/珲春街/树勋街/动植物公园/四道街
长春-南关区-东大桥	长通路/桃源/东天街/三道街/全安/新春
长春-南关区-大马路	二马路/新春/南街/大经路/三马路/西四道街
长春-南关区-净月镇	东南湖大路/临河/自由大路/东岭街/东天街/东岭南街
长春-南关区-动植物公园	文昌路/曙光路/平阳街/通化路/珲春街/体育场
长春-南关区-自由大路	临河/东岭街/东岭南街/南岭/东天街/全安
长春-南关区-三马路	二马路/新春/西五/大马路/大经路/西四道街
长春-南关区-平阳街	曙光路/通化路/珲春街/树勋街/四道街/民康路
长春-南关区-临河	自由大路/东岭街/东岭南街/南岭/净水路/亚泰大街
长春-南关区-全安	永吉/三道街/南关客运站/南街/南岭/桃源
长春-南关区-幸福街	雕塑公园/明珠/人民大街/隆礼路/磐石/文昌路
长春-南关区-岳阳街	树勋街/曙光路/平阳街/民康路/动植物公园/通化路
长春-南关区-三道街	全安/南街/大马路/永吉/二马路/大经路
长春-南关区-新春	二马路/大马路/西五/三马路/南街/大经路
长春-南关区-亚泰大街	体育场/南岭/东岭南街/鸿城/永吉/动植物公园
长春-南关区-卫星路	净水路/鸿城/东岭南街/磐石/亚泰大街/明珠
长春-南关区-东岭街	南岭/全安/永吉/东岭南街/亚泰大街/体育场
长春-南关区-明珠	雕塑公园/人民大街/磐石/卫星路/文昌路/鸿城
长春-南关区-大经路	西四道街/南街/大马路/二马路/三马路/平治街
长春-南关区-自强街	平治街/人民广场东/四道街/民康路/西四道街/三马路
长春-南关区-桃源	东大桥/长通路/东天街/三道街/全安/永吉
长春-南关区-西四道街	大经路/南街/平治街/三马路/二马路/大马路
长春-南关区-人民大街	明珠/雕塑公园/磐石/文昌路/动植物公园/卫星路
长春-南关区-解放大路	隆礼路/岳阳街/树勋街/民康路/清明街/人民广场东
长春-南关区-人民广场东	自强街/民康路/清明街/四道街/平治街/树勋街
长春-南关区-南岭	亚泰大街/体育场/东岭街/东岭南街/永吉/全安
长春-南关区-雕塑公园	明珠/人民大街/卫星路/磐石/净水路/幸福街
长春-南关区-珲春街	通化路/平阳街/曙光路/南关客运站/四道街/树勋街
长春-南关区-通化路	平阳街/珲春街/曙光路/树勋街/四道街/南关客运站
长春-南关区-清明街	人民广场东/自强街/民康路/上海路/平治街/四道街
长春-二道区-吉林	荣光/和顺/东站/东盛/万通/远达
长春-二道区-荣光	吉林/和顺/东站/东盛/八里堡/远达
长春-二道区-八里堡	远达/东站/和顺/东盛/荣光/万通
长春-二道区-东方广场	万通/东盛/远达/八里堡/和顺/东站
长春-二道区-东站	和顺/远达/荣光/八里堡/东盛/吉林
长春-二道区-和顺	东站/东盛/荣光/万通/远达/吉林
长春-二道区-东盛	万通/和顺/东站/远达/八里堡/荣光
长春-二道区-万通	东盛/和顺/东站/远达/荣光/八里堡
长春-二道区-远达	八里堡/东站/和顺/东盛/万通/荣光
长春-绿园区-锦程	创业大街/飞跃广场/锦江/和平大街/东风大街/中医院
长春-绿园区-万福街	正阳街/春城大街/中医院/景阳广场/青龙路/锦江
长春-绿园区-春草路	辽阳街/新竹/西安桥外/西安广场/普阳街/客车厂
长春-绿园区-皓月大路	弘海/飞跃广场/锦程/创业大街/西新/和平大街
长春-绿园区-西安桥外	客车厂/春草路/铁西/西安桥/辽阳街/新竹
长春-绿园区-青龙路	西安广场/万福街/春城大街/正阳街/中医院/新竹
长春-绿园区-正阳街	景阳广场/万福街/西安广场/春城大街/中医院/普阳街
长春-绿园区-东风大街	景阳广场/锦江/正阳街/万福街/春城大街/中医院
长春-绿园区-新竹	西安广场/春草路/辽阳街/青龙路/西安桥外/客车厂
长春-绿园区-西安广场	新竹/辽阳街/春草路/青龙路/正阳街/万福街
长春-绿园区-中医院	春城大街/万福街/和平大街/锦江/正阳街/景阳广场
长春-绿园区-铁西	西安桥/客车厂/西安桥外/青年路/春草路/辽阳街
长春-绿园区-西新	弘海/皓月大路/飞跃广场/锦程/创业大街/和平大街
长春-绿园区-客车厂	西安桥外/铁西/西安桥/青年路/春草路/辽阳街
长春-绿园区-创业大街	锦程/锦江/飞跃广场/和平大街/东风大街/中医院
长春-绿园区-锦江	和平大街/中医院/春城大街/万福街/东风大街/景阳广场
长春-绿园区-春城大街	中医院/万福街/和平大街/锦江/正阳街/景阳广场
长春-绿园区-飞跃广场	锦程/创业大街/弘海/皓月大路/和平大街/锦江
长春-绿园区-青年路	客车厂/西安桥外/铁西/新竹/春草路/西安桥
长春-绿园区-景阳广场	正阳街/万福街/普阳街/东风大街/春城大街/中医院
长春-绿园区-普阳街	辽阳街/春草路/景阳广场/正阳街/西安广场/西安桥外
长春-绿园区-辽阳街	春草路/普阳街/西安广场/西安桥外/新竹/正阳街
长春-绿园区-西安桥	铁西/西安桥外/客车厂/春草路/青年路/辽阳街
长春-绿园区-弘海	皓月大路/飞跃广场/西新/锦程/创业大街/和平大街
长春-绿园区-和平大街	锦江/中医院/春城大街/万福街/正阳街/景阳广场
长春-宽城区-新发	西广场/胜利/太阳城/华正/辽宁路/贵阳街
长春-宽城区-凯旋路	太阳城/华正/长新街/柳影路/西广场/站前
长春-宽城区-太阳城	西广场/华正/胜利/新发/辽宁路/凯旋路
长春-宽城区-东广场	黑水路/光复路/铁北/天光路/群英/南广场
长春-宽城区-兴业	群英/天光路/长新街/铁北/黑水路/东广场
长春-宽城区-南广场	贵阳街/站前/胜利/铁北/黑水路/群英
长春-宽城区-车轮厂	柳影路/辽宁路/凯旋路/太阳城/华正/西广场
长春-宽城区-柳影路	凯旋路/车轮厂/长新街/太阳城/辽宁路/华正
长春-宽城区-天光路	东广场/铁北/黑水路/光复路/群英/兴业
长春-宽城区-铁北	黑水路/群英/东广场/光复路/天光路/南广场
长春-宽城区-东安	天光路/东广场/光复路/团山/黑水路/铁北
长春-宽城区-站前	南广场/贵阳街/胜利/华正/西广场/群英
长春-宽城区-群英	铁北/黑水路/兴业/东广场/站前/长新街
长春-宽城区-胜利	西广场/华正/新发/太阳城/站前/贵阳街
长春-宽城区-辽宁路	太阳城/新发/西广场/华正/胜利/凯旋路
长春-宽城区-光复路	东广场/黑水路/铁北/天光路/南广场/群英
长春-宽城区-贵阳街	南广场/站前/胜利/西广场/华正/黑水路
长春-宽城区-长新街	群英/凯旋路/站前/兴业/华正/铁北
长春-宽城区-团山	天光路/东安/兴业/东广场/铁北/黑水路
长春-宽城区-华正	西广场/胜利/太阳城/站前/新发/贵阳街
长春-宽城区-黑水路	东广场/光复路/铁北/天光路/群英/南广场
长春-宽城区-西广场	华正/胜利/太阳城/新发/站前/贵阳街
长春-双阳区-新安	云山/平湖/山河/奢岭/鹿乡/土顶
长春-双阳区-云山	平湖/山河/新安/土顶/奢岭/鹿乡
长春-双阳区-土顶	山河/平湖/云山/新安/鹿乡/奢岭
长春-双阳区-山河	平湖/云山/新安/土顶/奢岭/鹿乡
长春-双阳区-鹿乡	奢岭/云山/平湖/山河/新安/太平
长春-双阳区-奢岭	鹿乡/新安/云山/平湖/山河/太平
长春-双阳区-太平	奢岭/鹿乡/新安/云山/平湖/山河
长春-双阳区-平湖	山河/云山/新安/土顶/奢岭/鹿乡
长春-汽车城-车管所	汽贸城/52街区/47街区/汽车厂区/一汽大众
长春-汽车城-汽贸城	车管所/52街区/47街区/汽车厂区/一汽大众
长春-汽车城-汽车厂区	47街区/52街区/车管所/一汽大众/汽贸城
长春-汽车城-52街区	汽车厂区/47街区/车管所/一汽大众/汽贸城
长春-汽车城-一汽大众	汽车厂区/52街区/47街区/车管所/汽贸城
长春-汽车城-47街区	汽车厂区/52街区/车管所/一汽大众/汽贸城
长春-朝阳区-新疆街	清华路/工农大路/义和路/文化广场/新民广场/同志街
长春-朝阳区-北安路	重庆路/锦水路/康平街/人民广场西/西安大路/东朝阳路
长春-朝阳区-富锋	开运街/孟家/辉南街/抚松路/湖光路/宽平大路
长春-朝阳区-长庆街	清华路/同光路/明水路/桂林路/同志街/工农大路
长春-朝阳区-百汇街	同光路/桂林路/永昌/同志街/义和路/清华路
长春-朝阳区-白菊	西安大路/康平街/普庆路/北安路/文化广场/锦水路
长春-朝阳区-建工学院	工学院/红旗街/建设街/建设广场/同德路/安达街
长春-朝阳区-同志街	义和路/永昌/清华路/同光路/百汇街/东朝阳路
长春-朝阳区-辉南街	抚松路/宽平大路/湖光路/湖西路/孟家/长久路
长春-朝阳区-繁荣路	前进大街/湖光路/长久路/南湖/长春理工大学/抚松路
长春-朝阳区-开运街	孟家/辉南街/抚松路/宽平大路/湖光路/湖西路
长春-朝阳区-孟家	辉南街/抚松路/宽平大路/湖光路/湖西路/开运街
长春-朝阳区-西朝阳路	西中华路/清和/大兴路/建设广场/建设街/安达街
长春-朝阳区-桂林路	同光路/明水路/百汇街/东北师大/同志街/长庆街
长春-朝阳区-义和路	同志街/永昌/清华路/东朝阳路/同光路/新疆街
长春-朝阳区-农大	卫星广场/省实验/东北师大/明水路/桂林路/西三道街
长春-朝阳区-宽平大路	抚松路/湖西路/辉南街/湖光路/长久路/孟家
长春-朝阳区-永昌	同志街/义和路/百汇街/同光路/清华路/东朝阳路
长春-朝阳区-长春理工大学	南湖/繁荣路/前进大街/延安大路/新民广场/工农大路
长春-朝阳区-长久路	建工学院/工学院/湖西路/宽平大路/抚松路/红旗街
长春-朝阳区-东朝阳路	锦水路/永昌/人民广场西/义和路/重庆路/北安路
长春-朝阳区-南湖	延安大路/长春理工大学/新民广场/同德路/工农大路/繁荣路
长春-朝阳区-新民广场	工农大路/新疆街/延安大路/长庆街/清华路/万宝街
长春-朝阳区-翔运街	安达街/大兴路/清和/西朝阳路/建设广场/西中华路
长春-朝阳区-锦水路	东朝阳路/重庆路/北安路/康平街/人民广场西/西安大路
长春-朝阳区-工学院	建工学院/红旗街/建设街/建设广场/同德路/安达街
长春-朝阳区-人民广场西	重庆路/东朝阳路/北安路/锦水路/永昌/义和路
长春-朝阳区-明水路	桂林路/长庆街/同光路/东北师大/百汇街/清华路
长春-朝阳区-重庆路	北安路/人民广场西/锦水路/东朝阳路/康平街/西安大路
长春-朝阳区-同光路	桂林路/同志街/百汇街/清华路/永昌/义和路
长春-朝阳区-卫星广场	省实验/明水路/东北师大/桂林路/长庆街/长春理工大学
长春-朝阳区-建设广场	大兴路/建设街/安达街/西朝阳路/西中华路/红旗街
长春-朝阳区-湖光路	抚松路/辉南街/宽平大路/湖西路/繁荣路/长久路
长春-朝阳区-中医学院	泰来街/湖西路/宽平大路/安达街/抚松路/长久路
长春-朝阳区-西三道街	人民广场西/重庆路/北安路/东朝阳路/百汇街/锦水路
长春-朝阳区-延安大路	同德路/南湖/新民广场/红旗街/工农大路/万宝街
长春-朝阳区-建设街	建设广场/红旗街/大兴路/西中华路/西朝阳路/万宝街
长春-朝阳区-普庆路	清和/白菊/西中华路/西朝阳路/文化广场/西安大路
长春-朝阳区-同德路	红旗街/延安大路/建设街/万宝街/工学院/建工学院
长春-朝阳区-前进大街	繁荣路/湖光路/长春理工大学/南湖/长久路/抚松路
长春-朝阳区-万宝街	西中华路/建设街/红旗街/同德路/西朝阳路/建设广场
长春-朝阳区-东北师大	桂林路/明水路/百汇街/同光路/同志街/永昌
长春-朝阳区-湖西路	宽平大路/抚松路/辉南街/长久路/中医学院/湖光路
长春-朝阳区-康平街	西安大路/北安路/锦水路/白菊/重庆路/东朝阳路
长春-朝阳区-抚松路	宽平大路/辉南街/湖西路/湖光路/长久路/孟家
长春-朝阳区-西安大路	康平街/白菊/锦水路/北安路/重庆路/东朝阳路
长春-朝阳区-泰来街	安达街/中医学院/建工学院/工学院/翔运街/建设广场
长春-朝阳区-西中华路	西朝阳路/大兴路/清和/建设广场/建设街/万宝街
长春-朝阳区-省实验	卫星广场/明水路/东北师大/桂林路/长庆街/同光路
长春-朝阳区-工农大路	新民广场/新疆街/长庆街/清华路/延安大路/文化广场
长春-朝阳区-安达街	大兴路/翔运街/建设广场/西朝阳路/建设街/西中华路
长春-朝阳区-大兴路	建设广场/西朝阳路/建设街/安达街/西中华路/翔运街
长春-朝阳区-清和	西朝阳路/西中华路/大兴路/翔运街/普庆路/建设广场
长春-朝阳区-清华路	同志街/义和路/同光路/永昌/新疆街/长庆街
长春-朝阳区-文化广场	新疆街/万宝街/西安大路/普庆路/锦水路/康平街
长春-朝阳区-红旗街	建设街/同德路/工学院/建工学院/建设广场/大兴路
大连-沙河口区-莲花山	白山路/太原街/万岁街/中山公园/民权/白云新村
大连-沙河口区-星海湾	星海广场/解放广场/台山/盖州街/太原街/西安路
大连-沙河口区-交大	西南路/辽师/南沙/富民路/绿波/台山
大连-沙河口区-黄河路	中山路/白云新村/中山公园/民权/莲花山/万岁街
大连-沙河口区-黑石礁	孙家沟/星海公园/台山/南沙/辽师/交大
大连-沙河口区-周水子	刘家桥/李家/春柳/绿波/车家村/西南路
大连-沙河口区-白山路	万岁街/太原街/莲花山/民权/解放广场/中山公园
大连-沙河口区-太原街	白山路/万岁街/莲花山/解放广场/西安路/民权
大连-沙河口区-辽师	交大/富民路/西南路/南沙/绿波/马栏
大连-沙河口区-春柳	李家/车家村/刘家桥/周水子/候家沟/绿波
大连-沙河口区-候家沟	车家村/春柳/兴工/盖州街/西安路/李家
大连-沙河口区-绿波	富民路/李家/周水子/刘家桥/西南路/辽师
大连-沙河口区-富民路	辽师/绿波/交大/西南路/马栏/李家
大连-沙河口区-车家村	候家沟/春柳/兴工/李家/盖州街/西安路
大连-沙河口区-星海公园	孙家沟/黑石礁/台山/南沙/星海湾/交大
大连-沙河口区-西安路	解放广场/兴工/盖州街/白山路/太原街/万岁街
大连-沙河口区-南沙	台山/交大/辽师/西南路/星海公园/孙家沟
大连-沙河口区-中山公园	民权/万岁街/白山路/莲花山/白云新村/太原街
大连-沙河口区-中山路	黄河路/白云新村/中山公园/民权/莲花山/万岁街
大连-沙河口区-民权	中山公园/万岁街/白山路/莲花山/太原街/西安路
大连-沙河口区-万岁街	白山路/民权/太原街/中山公园/莲花山/西安路
大连-沙河口区-星海广场	星海湾/太原街/解放广场/莲花山/白山路/西安路
大连-沙河口区-西南路	交大/辽师/绿波/李家/富民路/南沙
大连-沙河口区-白云新村	莲花山/中山路/中山公园/黄河路/民权/万岁街
大连-沙河口区-盖州街	西安路/解放广场/兴工/西南路/候家沟/星海湾
大连-沙河口区-刘家桥	周水子/李家/春柳/绿波/车家村/候家沟
大连-沙河口区-孙家沟	黑石礁/星海公园/台山/南沙/交大/辽师
大连-沙河口区-华北路	周水子/刘家桥/李家/锦绣/春柳/绿波
大连-沙河口区-锦绣	富民路/马栏/绿波/周水子/刘家桥/辽师
大连-沙河口区-解放广场	西安路/太原街/兴工/白山路/盖州街/万岁街
大连-沙河口区-李家	刘家桥/周水子/春柳/绿波/西南路/富民路
大连-沙河口区-兴工	西安路/解放广场/候家沟/盖州街/车家村/万岁街
大连-沙河口区-台山	南沙/星海公园/交大/星海湾/孙家沟/盖州街
大连-沙河口区-马栏	富民路/锦绣/辽师/绿波/交大/南沙
大连-旅顺口区-铁山	江西/光荣/水师营/得胜/登峰/市场
大连-旅顺口区-光荣	得胜/水师营/登峰/市场/铁山/江西
大连-旅顺口区-市场	登峰/得胜/光荣/水师营/铁山/江西
大连-旅顺口区-旅顺开发区	和平公园/市场/登峰/得胜/水师营/光荣
大连-旅顺口区-水师营	光荣/得胜/登峰/市场/铁山/江西
大连-旅顺口区-江西	铁山/水师营/光荣/得胜/登峰/市场
大连-旅顺口区-和平公园	旅顺开发区/市场/登峰/得胜/水师营/光荣
大连-旅顺口区-得胜	登峰/市场/光荣/水师营/铁山/江西
大连-旅顺口区-登峰	市场/得胜/光荣/水师营/铁山/江西
大连-中山区-秀月街	桃源街/解放路/青云街/葵英街/景山小区/武昌街
大连-中山区-青云街	解放路/武昌街/葵英街/昆明街/秀月街/桃源街
大连-中山区-葵英街	七七街/解放路/武昌街/青云街/桃源街/桂林街
大连-中山区-寺儿沟	海军广场/二七广场/桂林街/港湾广场/三八广场/华乐广场
大连-中山区-解放路	青云街/葵英街/武昌街/桃源街/秀月街/七七街
大连-中山区-港湾广场	三八广场/二七广场/桂林街/海军广场/人民路/寺儿沟
大连-中山区-山屏街	中南路/华乐广场/老虎滩/景山小区/寺儿沟/海军广场
大连-中山区-火车站	青泥洼桥/希望广场/友好广场/劳动公园/胜利桥/唐山街
大连-中山区-华乐广场	山屏街/中南路/寺儿沟/海军广场/老虎滩/二七广场
大连-中山区-希望广场	唐山街/火车站/青泥洼桥/老鳖湾/劳动公园/友好广场
大连-中山区-长江路	唐山街/希望广场/火车站/青泥洼桥/老鳖湾/劳动公园
大连-中山区-民主广场	人民路/天津街/中山广场/七七街/胜利桥/友好广场
大连-中山区-景山小区	中南路/桃源街/山屏街/秀月街/桂林街/葵英街
大连-中山区-大外	华乐广场/寺儿沟/海军广场/山屏街/老虎滩/港湾广场
大连-中山区-中山广场	天津街/友好广场/胜利桥/民主广场/昆明街/劳动公园
大连-中山区-人民路	民主广场/七七街/三八广场/中山广场/天津街/港湾广场
大连-中山区-桃源街	秀月街/解放路/葵英街/青云街/景山小区/武昌街
大连-中山区-老虎滩	山屏街/中南路/华乐广场/景山小区/寺儿沟/海军广场
大连-中山区-友好广场	胜利桥/中山广场/天津街/劳动公园/青泥洼桥/昆明街
大连-中山区-昆明街	劳动公园/武昌街/友好广场/中山广场/天津街/青泥洼桥
大连-中山区-二七广场	桂林街/港湾广场/三八广场/海军广场/寺儿沟/人民路
大连-中山区-胜利桥	天津街/友好广场/中山广场/青泥洼桥/劳动公园/民主广场
大连-中山区-劳动公园	昆明街/青泥洼桥/友好广场/中山广场/老鳖湾/胜利桥
大连-中山区-老鳖湾	希望广场/劳动公园/青泥洼桥/唐山街/昆明街/火车站
大连-中山区-七七街	人民路/葵英街/武昌街/民主广场/三八广场/中山广场
大连-中山区-唐山街	希望广场/老鳖湾/火车站/长江路/青泥洼桥/劳动公园
大连-中山区-三八广场	港湾广场/桂林街/二七广场/人民路/七七街/葵英街
大连-中山区-中南路	山屏街/景山小区/老虎滩/华乐广场/寺儿沟/海军广场
大连-中山区-海军广场	寺儿沟/二七广场/桂林街/港湾广场/三八广场/华乐广场
大连-中山区-天津街	中山广场/胜利桥/友好广场/民主广场/昆明街/劳动公园
大连-中山区-武昌街	昆明街/七七街/青云街/解放路/葵英街/劳动公园
大连-中山区-青泥洼桥	火车站/劳动公园/友好广场/希望广场/胜利桥/昆明街
大连-中山区-桂林街	二七广场/三八广场/港湾广场/海军广场/寺儿沟/葵英街
大连-金州区-大李家	登沙河/华家屯/二十里堡/三十里堡/金马路/先进
大连-金州区-胜利路	光明/友谊/斯大林路/站前/中长/拥政
大连-金州区-大魏家	拥政/友谊/中长/斯大林路/光明/站前
大连-金州区-三十里堡	二十里堡/大魏家/先进/拥政/中长/金马路
大连-金州区-斯大林路	站前/中长/友谊/光明/拥政/先进
大连-金州区-拥政	中长/斯大林路/站前/友谊/光明/先进
大连-金州区-先进	中长/站前/拥政/斯大林路/金马路/光明
大连-金州区-登沙河	大李家/华家屯/二十里堡/三十里堡/金马路/先进
大连-金州区-二十里堡	三十里堡/金马路/先进/拥政/中长/站前
大连-金州区-中长	拥政/斯大林路/站前/友谊/光明/先进
大连-金州区-友谊	斯大林路/光明/拥政/站前/中长/先进
大连-金州区-站前	斯大林路/中长/拥政/光明/友谊/先进
大连-金州区-得胜	胜利路/光明/友谊/斯大林路/站前/大魏家
大连-金州区-光明	友谊/斯大林路/站前/中长/拥政/先进
大连-金州区-华家屯	登沙河/大李家/二十里堡/三十里堡/金马路/先进
大连-金州区-金马路	先进/站前/中长/斯大林路/拥政/光明
大连-高新园区-理工大学	凌水/海事大学/软件园/东软/庙岭/高新园区管委会
大连-高新园区-软件园	凌水/理工大学/庙岭/红凌路/东软/海事大学
大连-高新园区-高新园区管委会	七贤岭/海事大学/理工大学/凌水/软件园/大有恬园
大连-高新园区-龙王塘	黄泥川/小平岛/百合山庄/大有恬园/高新园区管委会/庙岭
大连-高新园区-海事大学	理工大学/凌水/软件园/东软/高新园区管委会/七贤岭
大连-高新园区-七贤岭	高新园区管委会/海事大学/理工大学/凌水/软件园/大有恬园
大连-高新园区-百合山庄	大有恬园/庙岭/高新园区管委会/软件园/凌水/七贤岭
大连-高新园区-红凌路	软件园/庙岭/东软/凌水/理工大学/海事大学
大连-高新园区-东软	软件园/凌水/理工大学/红凌路/数码广场/海事大学
大连-高新园区-庙岭	软件园/凌水/红凌路/理工大学/大有恬园/东软
大连-高新园区-凌水	理工大学/软件园/海事大学/庙岭/东软/红凌路
大连-高新园区-黄泥川	龙王塘/小平岛/百合山庄/大有恬园/庙岭/高新园区管委会
大连-高新园区-东财	好又多/数码广场/东软/海事大学/理工大学/凌水
大连-高新园区-数码广场	好又多/东财/东软/海事大学/理工大学/凌水
大连-高新园区-大有恬园	百合山庄/庙岭/软件园/凌水/高新园区管委会/理工大学
大连-高新园区-好又多	数码广场/东财/东软/海事大学/理工大学/凌水
大连-高新园区-小平岛	百合山庄/大有恬园/七贤岭/高新园区管委会/庙岭/理工大学
大连-甘井子区-金三角	大纺/华南广场/中华路/兴华/山东路/王家桥
大连-甘井子区-中华路	泉水/华南广场/金三角/南关岭/椒金山/椒房
大连-甘井子区-革镇堡	张前路/辛寨子/机场/泡崖/华北路/张家村
大连-甘井子区-后盐	姚家/甘井子/南关岭/泉水/椒金山/椒房
大连-甘井子区-周水子	促进路/王家桥/泡崖/华北路/春柳河/千山路
大连-甘井子区-千山路	山东路/兴华/华北路/王家桥/华南广场/促进路
大连-甘井子区-张前路	辛寨子/张家村/革镇堡/西山水库/机场/大连湾
大连-甘井子区-大连湾	西山水库/红旗/张家村/机场/辛寨子/泡崖
大连-甘井子区-椒房	椒金山/金三角/中华路/甘井子/泉水/大纺
大连-甘井子区-南关岭	泉水/姚家/中华路/华南广场/椒金山/金三角
大连-甘井子区-促进路	王家桥/春柳河/周水子/大纺/兴华/山东路
大连-甘井子区-王家桥	促进路/春柳河/兴华/大纺/山东路/千山路
大连-甘井子区-椒金山	椒房/中华路/金三角/泉水/甘井子/大纺
大连-甘井子区-西部通道	春柳河/促进路/王家桥/大纺/周水子/金三角
大连-甘井子区-姚家	南关岭/泉水/后盐/中华路/椒金山/甘井子
大连-甘井子区-辛寨子	张前路/张家村/西山水库/大连湾/革镇堡/机场
大连-甘井子区-甘井子	椒房/椒金山/后盐/姚家/泉水/中华路
大连-甘井子区-泉水	南关岭/中华路/华南广场/姚家/椒金山/金三角
大连-甘井子区-营城子	溪之谷/张前路/辛寨子/张家村/革镇堡/西山水库
大连-甘井子区-机场	泡崖/红旗/大连湾/周水子/西山水库/华北路
大连-甘井子区-山东路	兴华/千山路/华南广场/王家桥/华北路/大纺
大连-甘井子区-华南广场	中华路/山东路/兴华/千山路/金三角/泉水
大连-甘井子区-春柳河	促进路/王家桥/大纺/兴华/周水子/金三角
大连-甘井子区-华北路	千山路/泡崖/山东路/兴华/周水子/王家桥
大连-甘井子区-西山水库	大连湾/红旗/张家村/机场/辛寨子/张前路
大连-甘井子区-红旗	大连湾/西山水库/机场/周水子/泡崖/张家村
大连-甘井子区-张家村	辛寨子/西山水库/大连湾/张前路/红旗/机场
大连-甘井子区-大纺	金三角/王家桥/春柳河/兴华/促进路/山东路
大连-甘井子区-兴华	山东路/千山路/王家桥/华南广场/大纺/促进路
大连-甘井子区-泡崖	华北路/机场/周水子/千山路/山东路/促进路
大连-甘井子区-溪之谷	张家村/张前路/辛寨子/西山水库/大连湾/红旗
大连-西岗区-胜利路	体育场/奥林匹克广场/高尔基路/大同街/白云/五一广场
大连-西岗区-五一广场	大同街/鞍山路/奥林匹克广场/体育场/胜利路/高尔基路
大连-西岗区-高尔基路	白云/胜利路/奥林匹克广场/体育场/大同街/五一广场
大连-西岗区-黄河路	北京街/新开路/人民广场/日新/北岗桥/东关街
大连-西岗区-付家庄	八一路/仲夏路/新起屯/石道街/长春路/石葵路
大连-西岗区-八一路	仲夏路/付家庄/新起屯/石道街/长春路/石葵路
大连-西岗区-石道街	长春路/34中/实验小学/新起屯/英华街/人民广场
大连-西岗区-体育场	奥林匹克广场/大同街/胜利路/高尔基路/五一广场/人民广场
大连-西岗区-日新	北岗桥/新开路/北京街/黄河路/东关街/人民广场
大连-西岗区-白云	高尔基路/胜利路/奥林匹克广场/体育场/大同街/五一广场
大连-西岗区-香炉礁	工人村/鞍山路/五一广场/大同街/奥林匹克广场/高尔基路
大连-西岗区-胜利桥北	大菜市/站北/英华街/实验小学/石葵路/东关街
大连-西岗区-鞍山路	五一广场/大同街/香炉礁/奥林匹克广场/工人村/体育场
大连-西岗区-东关街	日新/英华街/新开路/实验小学/34中/北岗桥
大连-西岗区-石葵路	新起屯/石道街/实验小学/胜利桥北/英华街/站北
大连-西岗区-北京街	黄河路/新开路/人民广场/日新/北岗桥/东关街
大连-西岗区-英华街	实验小学/站北/34中/东关街/大菜市/新开路
大连-西岗区-北岗桥	日新/北京街/黄河路/新开路/人民广场/东关街
大连-西岗区-奥林匹克广场	体育场/大同街/胜利路/五一广场/高尔基路/人民广场
大连-西岗区-长春路	石道街/34中/人民广场/新开路/黄河路/实验小学
大连-西岗区-新开路	黄河路/北京街/日新/人民广场/北岗桥/东关街
大连-西岗区-站北	大菜市/英华街/实验小学/东关街/34中/胜利桥北
大连-西岗区-34中	实验小学/英华街/长春路/东关街/新开路/石道街
大连-西岗区-新起屯	石葵路/仲夏路/石道街/八一路/付家庄/长春路
大连-西岗区-工人村	香炉礁/鞍山路/五一广场/大同街/奥林匹克广场/体育场
大连-西岗区-实验小学	英华街/站北/34中/东关街/大菜市/新开路
大连-西岗区-大菜市	站北/英华街/实验小学/胜利桥北/东关街/34中
大连-西岗区-人民广场	黄河路/北京街/新开路/日新/北岗桥/大同街
大连-西岗区-仲夏路	八一路/付家庄/新起屯/石道街/长春路/石葵路
大连-西岗区-大同街	奥林匹克广场/体育场/五一广场/胜利路/高尔基路/人民广场
沈阳-和平区-马路湾	八经/砂山/中山广场/云集/遂川/和平广场
沈阳-和平区-三好街	五里河/十四纬路/云集/砂山/八经/马路湾
沈阳-和平区-北市	北道口/遂川/八经/砂山/云集/十四纬路
沈阳-和平区-五里河	三好街/十四纬路/云集/新兴/砂山/八经
沈阳-和平区-云集	十四纬路/砂山/八经/马路湾/三好街/遂川
沈阳-和平区-西塔	中山广场/吴淞/遂川/中华路/南站/太原街
沈阳-和平区-和平广场	运动系/新华/集贤/中华路/文体西路/民主
沈阳-和平区-太原街	南站/中华路/民主/吴淞/中山广场/新华
沈阳-和平区-中华路	太原街/南站/中山广场/吴淞/民主/新华
沈阳-和平区-文体西路	和平广场/运动系/新华/马路湾/集贤/长白
沈阳-和平区-北道口	北市/遂川/皇寺/八经/砂山/云集
沈阳-和平区-砂山	八经/云集/十四纬路/马路湾/遂川/北市
沈阳-和平区-八经	砂山/遂川/云集/马路湾/北市/十四纬路
沈阳-和平区-长白	文体西路/运动系/和平广场/集贤/南京街/新华
沈阳-和平区-中山广场	中华路/吴淞/西塔/太原街/南站/马路湾
沈阳-和平区-新兴	五里河/皇寺/三好街/十四纬路/云集/北道口
沈阳-和平区-吴淞	南站/太原街/中华路/中山广场/西塔/民主
沈阳-和平区-民主	太原街/南站/中华路/集贤/新华/南京街
沈阳-和平区-集贤	南京街/新华/运动系/民主/和平广场/南湖
沈阳-和平区-运动系	新华/和平广场/集贤/民主/南京街/中华路
沈阳-和平区-遂川	八经/北市/西塔/砂山/马路湾/中山广场
沈阳-和平区-十四纬路	云集/砂山/八经/三好街/马路湾/北市
沈阳-和平区-南京街	集贤/南湖/民主/胜利/新华/运动系
沈阳-和平区-南湖	胜利/南京街/民主/集贤/南站/太原街
沈阳-和平区-皇寺	北道口/北市/八经/遂川/砂山/新兴
沈阳-和平区-新华	运动系/和平广场/集贤/民主/中华路/太原街
沈阳-和平区-南站	太原街/吴淞/中华路/民主/中山广场/新华
沈阳-和平区-胜利	南湖/南京街/民主/集贤/南站/太原街
沈阳-大东区-大北	八王寺/小东/小北/五中家乐福/小津桥/洮昌
沈阳-大东区-滂江街	万泉/长安/东塔/大东路/小津桥/204医院
沈阳-大东区-万泉	长安/滂江街/东塔/大东路/204医院/珠林
沈阳-大东区-东北大马路	东站/珠林/204医院/新东/北海街/二台子
沈阳-大东区-东站	东北大马路/珠林/204医院/新东/北海街/二台子
沈阳-大东区-吉祥	辽沈/洮昌/五中家乐福/老瓜堡/北海街/小津桥
沈阳-大东区-724地区	丰乐/小东/大东路/大北/小津桥/滂江街
沈阳-大东区-北海街	老瓜堡/辽沈/吉祥/上园路/二台子/洮昌
沈阳-大东区-老瓜堡	上园路/二台子/北海街/辽沈/吉祥/洮昌
沈阳-大东区-陶瓷城	新东/东站/东北大马路/珠林/204医院/北大营
沈阳-大东区-二台子	上园路/老瓜堡/北海街/辽沈/北大营/吉祥
沈阳-大东区-小北	八王寺/大北/小东/五中家乐福/洮昌/小津桥
沈阳-大东区-丰乐	724地区/滂江街/万泉/长安/大东路/东塔
沈阳-大东区-北大营	二台子/上园路/老瓜堡/北海街/望花/辽沈
沈阳-大东区-五中家乐福	洮昌/吉祥/小津桥/辽沈/小东/大北
沈阳-大东区-东塔	长安/万泉/滂江街/204医院/珠林/大东路
沈阳-大东区-新东	东站/东北大马路/204医院/珠林/陶瓷城/东塔
沈阳-大东区-大东路	小津桥/滂江街/万泉/小东/长安/五中家乐福
沈阳-大东区-小东	大北/八王寺/五中家乐福/小津桥/大东路/小北
沈阳-大东区-望花	北大营/二台子/上园路/老瓜堡/北海街/吉祥
沈阳-大东区-长安	万泉/东塔/滂江街/204医院/大东路/珠林
沈阳-大东区-珠林	204医院/东塔/长安/东北大马路/万泉/北海街
沈阳-大东区-小津桥	大东路/五中家乐福/洮昌/吉祥/辽沈/小东
沈阳-大东区-洮昌	吉祥/五中家乐福/辽沈/小津桥/老瓜堡/北海街
沈阳-大东区-辽沈	吉祥/北海街/洮昌/老瓜堡/五中家乐福/小津桥
沈阳-大东区-204医院	珠林/东塔/长安/万泉/东北大马路/北海街
沈阳-大东区-八王寺	大北/小北/小东/五中家乐福/洮昌/小津桥
沈阳-大东区-上园路	二台子/老瓜堡/北海街/辽沈/吉祥/北大营
沈阳-苏家屯区-临湖	解放/民主/城郊/铁友/湖西/中兴
沈阳-苏家屯区-湖西	城郊/解放/临湖/铁友/民主/中兴
沈阳-苏家屯区-城郊	解放/湖西/临湖/民主/铁友/中兴
沈阳-苏家屯区-铁友	民主/解放/临湖/城郊/湖西/中兴
沈阳-苏家屯区-民主	铁友/临湖/解放/城郊/湖西/中兴
沈阳-苏家屯区-解放	临湖/城郊/民主/铁友/湖西/中兴
沈阳-苏家屯区-中兴	铁友/民主/临湖/解放/城郊/湖西
沈阳-铁西区-启工	肇工街/家具城/北四路/卫工/工人村/保工
沈阳-铁西区-工人村	重工/铁西体育场/西站/肇工街/启工/北四路
沈阳-铁西区-北三路	北二路/齐贤/九路市场/十二路/贵和/兴顺
沈阳-铁西区-铁西区政府	兴华/建设大路/铁西广场/爱工街/兴工/啤酒厂
沈阳-铁西区-北四路	肇工街/启工/家具城/卫工/工人村/铁西体育场
沈阳-铁西区-兴顺	齐贤/十二路/九路市场/贵和/北三路/铁百
沈阳-铁西区-贵和	铁百/九路市场/铁西广场/云峰/齐贤/兴顺
沈阳-铁西区-路官	保工/艳粉/启工/家具城/卫工/肇工街
沈阳-铁西区-齐贤	兴顺/十二路/九路市场/北三路/贵和/铁百
沈阳-铁西区-卫工	家具城/十二路/启工/北四路/齐贤/兴顺
沈阳-铁西区-霁虹	爱工街/兴华/啤酒厂/兴工/铁西区政府/建设大路
沈阳-铁西区-十二路	齐贤/兴顺/九路市场/卫工/北三路/贵和
沈阳-铁西区-重工	西站/铁西体育场/工人村/肇工街/启工/保工
沈阳-铁西区-家具城	卫工/启工/北四路/肇工街/十二路/保工
沈阳-铁西区-劳动公园	路官/艳粉/保工/滑翔小区/凌空/西站
沈阳-铁西区-北二路	北三路/九路市场/贵和/铁西广场/齐贤/铁百
沈阳-铁西区-滑翔小区	凌空/云峰/建设大路/铁百/铁西广场/贵和
沈阳-铁西区-艳粉	路官/兴顺/保工/十二路/齐贤/九路市场
沈阳-铁西区-铁西体育场	重工/工人村/西站/肇工街/启工/北四路
沈阳-铁西区-保工	路官/艳粉/启工/家具城/肇工街/工人村
沈阳-铁西区-九路市场	贵和/齐贤/铁百/兴顺/北三路/铁西广场
沈阳-铁西区-啤酒厂	兴工/爱工街/兴华/建设大路/铁西区政府/凌空
沈阳-铁西区-铁百	贵和/铁西广场/云峰/九路市场/建设大路/齐贤
沈阳-铁西区-肇工街	启工/北四路/家具城/工人村/卫工/铁西体育场
沈阳-铁西区-云峰	铁西广场/铁百/建设大路/滑翔小区/贵和/凌空
沈阳-铁西区-凌空	滑翔小区/云峰/建设大路/兴工/啤酒厂/铁西广场
沈阳-铁西区-兴华	爱工街/啤酒厂/兴工/铁西区政府/建设大路/铁西广场
沈阳-铁西区-工业大学	霁虹/爱工街/兴华/啤酒厂/铁西区政府/兴工
沈阳-铁西区-建设大路	铁西广场/云峰/铁西区政府/兴工/铁百/啤酒厂
沈阳-铁西区-兴工	啤酒厂/兴华/爱工街/建设大路/铁西区政府/凌空
沈阳-铁西区-沈辽路	西站/重工/铁西体育场/工人村/保工/肇工街
沈阳-铁西区-西站	重工/工人村/铁西体育场/保工/肇工街/启工
沈阳-铁西区-爱工街	兴华/啤酒厂/兴工/铁西区政府/建设大路/霁虹
沈阳-铁西区-铁西广场	铁百/建设大路/云峰/贵和/铁西区政府/九路市场
沈阳-法库县-丁家房	登仕堡子/三面船/秀水河子/大孤家子/法库/叶茂台
沈阳-法库县-法库	大孤家子/柏家沟/三面船/丁家房/登仕堡子/秀水河子
沈阳-法库县-秀水河子	登仕堡子/叶茂台/丁家房/三面船/大孤家子/法库
沈阳-法库县-登仕堡子	丁家房/秀水河子/三面船/叶茂台/大孤家子/法库
沈阳-法库县-叶茂台	秀水河子/登仕堡子/丁家房/三面船/大孤家子/法库
沈阳-法库县-柏家沟	法库/大孤家子/三面船/丁家房/登仕堡子/秀水河子
沈阳-法库县-三面船	大孤家子/丁家房/登仕堡子/法库/秀水河子/柏家沟
沈阳-法库县-大孤家子	三面船/法库/丁家房/登仕堡子/柏家沟/秀水河子
沈阳-康平县-张强	二牛所口/方家屯/小城子/东关屯/康平/郝官屯
沈阳-康平县-康平	东关屯/郝官屯/方家屯/小城子/二牛所口/张强
沈阳-康平县-二牛所口	小城子/方家屯/张强/东关屯/康平/郝官屯
沈阳-康平县-东关屯	康平/方家屯/郝官屯/小城子/二牛所口/张强
沈阳-康平县-小城子	二牛所口/方家屯/东关屯/康平/张强/郝官屯
沈阳-康平县-方家屯	二牛所口/东关屯/小城子/康平/张强/郝官屯
沈阳-康平县-郝官屯	康平/东关屯/方家屯/小城子/二牛所口/张强
沈阳-新民市-新城	东城/辽滨/西城/新柳
沈阳-新民市-东城	辽滨/西城/新柳/新城
沈阳-新民市-辽滨	西城/新柳/东城/新城
沈阳-新民市-新柳	西城/辽滨/东城/新城
沈阳-新民市-西城	新柳/辽滨/东城/新城
沈阳-沈河区-市府广场	一经/二经/小西/惠工/北站/山东庙
沈阳-沈河区-二经	一经/山东庙/市府广场/文艺路/顺通/小西
沈阳-沈河区-滨河	大南/小南/五爱市场/中街/正阳街/万莲
沈阳-沈河区-文化路	文艺路/顺通/风雨坛/南塔/山东庙/小南
沈阳-沈河区-广宜街	小西/北站/大西街/惠工/展览馆/正阳街
沈阳-沈河区-五爱市场	小南/风雨坛/正阳街/大西街/大南/顺通
沈阳-沈河区-顺通	文艺路/风雨坛/文化路/大西街/五爱市场/小西
沈阳-沈河区-一经	二经/山东庙/市府广场/文艺路/顺通/小西
沈阳-沈河区-北站	惠工/广宜街/小西/展览馆/大西街/市府广场
沈阳-沈河区-风雨坛	顺通/五爱市场/大西街/小南/文艺路/小西
沈阳-沈河区-方家栏	万莲/滨河/大南/中街/小南/正阳街
沈阳-沈河区-小西	广宜街/大西街/北站/惠工/风雨坛/顺通
沈阳-沈河区-大西街	小西/广宜街/风雨坛/五爱市场/正阳街/顺通
沈阳-沈河区-山东庙	一经/二经/市府广场/文艺路/顺通/文化路
沈阳-沈河区-展览馆	正阳街/广宜街/北站/惠工/中街/大西街
沈阳-沈河区-文艺路	顺通/文化路/风雨坛/山东庙/南塔/大西街
沈阳-沈河区-大南	滨河/小南/五爱市场/正阳街/中街/风雨坛
沈阳-沈河区-万莲	滨河/大南/中街/方家栏/小南/正阳街
沈阳-沈河区-惠工	北站/广宜街/小西/市府广场/大西街/展览馆
沈阳-沈河区-正阳街	五爱市场/大西街/中街/小南/展览馆/大南
沈阳-沈河区-小南	五爱市场/大南/风雨坛/正阳街/滨河/大西街
沈阳-沈河区-中街	正阳街/大南/展览馆/滨河/五爱市场/小南
沈阳-沈河区-南塔	小南/文化路/风雨坛/文艺路/五爱市场/顺通
沈阳-沈北新区-虎石台	新城子/辉山/蒲河/财落/清水台/道义
沈阳-沈北新区-辉山	蒲河/清水台/虎石台/新城子/财落/道义
沈阳-沈北新区-道义	财落/兴隆台锡伯族/虎石台/新城子/辉山/蒲河
沈阳-沈北新区-蒲河	辉山/清水台/虎石台/新城子/财落/道义
沈阳-沈北新区-兴隆台锡伯族	道义/财落/新城子/虎石台/辉山/蒲河
沈阳-沈北新区-财落	道义/兴隆台锡伯族/新城子/虎石台/辉山/蒲河
沈阳-沈北新区-新城子	虎石台/财落/清水台/辉山/蒲河/道义
沈阳-沈北新区-清水台	蒲河/辉山/新城子/虎石台/财落/道义
沈阳-辽中县-肖寨门	茨榆坨/刘二堡/四方台/辽中/冷子堡/杨士岗
沈阳-辽中县-刘二堡	茨榆坨/冷子堡/四方台/杨士岗/肖寨门/新民屯
沈阳-辽中县-长滩	新民屯/四方台/杨士岗/茨榆坨/刘二堡/肖寨门
沈阳-辽中县-新民屯	长滩/杨士岗/四方台/刘二堡/茨榆坨/肖寨门
沈阳-辽中县-冷子堡	刘二堡/辽中/茨榆坨/肖寨门/满都户/四方台
沈阳-辽中县-辽中	朱家房/满都户/冷子堡/肖寨门/茨榆坨/于家房
沈阳-辽中县-朱家房	于家房/辽中/满都户/肖寨门/冷子堡/茨榆坨
沈阳-辽中县-于家房	朱家房/辽中/满都户/肖寨门/冷子堡/茨榆坨
沈阳-辽中县-茨榆坨	肖寨门/刘二堡/四方台/冷子堡/杨士岗/辽中
沈阳-辽中县-四方台	杨士岗/长滩/新民屯/茨榆坨/刘二堡/肖寨门
沈阳-辽中县-杨士岗	新民屯/四方台/长滩/刘二堡/茨榆坨/肖寨门
沈阳-辽中县-满都户	辽中/朱家房/冷子堡/于家房/肖寨门/刘二堡
沈阳-于洪区-沈辽路	杨士/于洪广场/于洪/迎宾路/于洪区委/城东湖
沈阳-于洪区-大兴乡	马三家/和泰新城/于洪区委/沙岭/迎宾路/于洪
沈阳-于洪区-迎宾路	于洪广场/于洪区委/于洪/和泰新城/沈辽路/杨士
沈阳-于洪区-丁香湖	荷兰村/造化/于洪新城/白山路/城东湖/于洪广场
沈阳-于洪区-沙岭	和泰新城/大兴乡/于洪区委/于洪/翟家/迎宾路
沈阳-于洪区-翟家	沙岭/于洪/和泰新城/于洪区委/沈辽路/迎宾路
沈阳-于洪区-于洪区委	和泰新城/于洪/迎宾路/于洪广场/沈辽路/杨士
沈阳-于洪区-造化	荷兰村/丁香湖/白山路/松山小区/国奥现代城/于洪新城
沈阳-于洪区-杨士	沈辽路/于洪广场/于洪/城东湖/迎宾路/于洪区委
沈阳-于洪区-松山小区	国奥现代城/白山路/荷兰村/造化/丁香湖/于洪新城
沈阳-于洪区-大潘镇	翟家/沙岭/大兴乡/和泰新城/马三家/于洪
沈阳-于洪区-和泰新城	于洪区委/于洪/迎宾路/于洪广场/沈辽路/杨士
沈阳-于洪区-荷兰村	造化/丁香湖/白山路/松山小区/国奥现代城/于洪新城
沈阳-于洪区-国奥现代城	松山小区/白山路/荷兰村/造化/丁香湖/于洪新城
沈阳-于洪区-于洪广场	迎宾路/于洪区委/于洪/和泰新城/沈辽路/杨士
沈阳-于洪区-于洪	于洪区委/和泰新城/迎宾路/于洪广场/沈辽路/杨士
沈阳-于洪区-白山路	松山小区/国奥现代城/荷兰村/造化/丁香湖/于洪新城
沈阳-于洪区-城东湖	杨士/沈辽路/于洪新城/于洪广场/迎宾路/于洪
沈阳-于洪区-马三家	大兴乡/沙岭/和泰新城/于洪区委/迎宾路/于洪
沈阳-于洪区-于洪新城	城东湖/杨士/丁香湖/沈辽路/于洪广场/荷兰村
沈阳-皇姑区-黑龙江街	辽河街/五一商店/泰山路/陵东/公安厅/北塔
沈阳-皇姑区-五一商店	黑龙江街/辽河街/泰山路/公安厅/陵东/北塔
沈阳-皇姑区-陵东	辽河街/泰山路/黑龙江街/北塔/五一商店/公安厅
沈阳-皇姑区-黄河	昆山路/公安厅/北行/崇山/新乐/北陵
沈阳-皇姑区-怒江北街	陵西/长江街/百鸟公园/太平/北陵/华山
沈阳-皇姑区-向工	明廉/塔湾/寿泉/太平/皇姑屯火车站/怒江北街
沈阳-皇姑区-泰山路	五一商店/陵东/黑龙江街/辽河街/公安厅/黄河
沈阳-皇姑区-北陵	新乐/长江街/陵西/三台子/崇山/北行
沈阳-皇姑区-崇山	北行/昆山路/黄河/陵西/三洞桥/北陵
沈阳-皇姑区-皇姑屯火车站	华山/寿泉/珠江桥/亚明/太平/百鸟公园
沈阳-皇姑区-珠江桥	亚明/三洞桥/华山/皇姑屯火车站/百鸟公园/北行
沈阳-皇姑区-三台子	新乐/北陵/长江街/陵西/泰山路/黄河
沈阳-皇姑区-陵西	长江街/北陵/新乐/崇山/百鸟公园/北行
沈阳-皇姑区-北行	崇山/昆山路/黄河/三洞桥/陵西/百鸟公园
沈阳-皇姑区-太平	寿泉/皇姑屯火车站/华山/百鸟公园/塔湾/怒江北街
沈阳-皇姑区-寿泉	太平/皇姑屯火车站/华山/百鸟公园/塔湾/珠江桥
沈阳-皇姑区-昆山路	北行/崇山/黄河/三洞桥/公安厅/亚明
沈阳-皇姑区-公安厅	五一商店/黄河/黑龙江街/泰山路/辽河街/昆山路
沈阳-皇姑区-辽河街	黑龙江街/五一商店/陵东/泰山路/北塔/公安厅
沈阳-皇姑区-长客	北塔/陵东/辽河街/黑龙江街/五一商店/泰山路
沈阳-皇姑区-明廉	向工/塔湾/寿泉/太平/皇姑屯火车站/华山
沈阳-皇姑区-新乐	北陵/长江街/陵西/三台子/崇山/北行
沈阳-皇姑区-塔湾	太平/寿泉/向工/明廉/皇姑屯火车站/怒江北街
沈阳-皇姑区-三洞桥	亚明/珠江桥/华山/百鸟公园/北行/崇山
沈阳-皇姑区-亚明	三洞桥/珠江桥/华山/百鸟公园/皇姑屯火车站/北行
沈阳-皇姑区-华山	亚明/百鸟公园/珠江桥/皇姑屯火车站/三洞桥/寿泉
沈阳-皇姑区-百鸟公园	华山/亚明/三洞桥/陵西/珠江桥/崇山
沈阳-皇姑区-长江街	陵西/北陵/新乐/怒江北街/崇山/北行
沈阳-皇姑区-北塔	辽河街/陵东/黑龙江街/五一商店/长客/泰山路
沈阳-东陵区-白塔	浑河站东/前进/五三/桃仙/浑河站西/马官桥
沈阳-东陵区-东陵	东湖/英达/丰乐/泉园/马官桥/浑河站西
沈阳-东陵区-英达	东湖/东陵/丰乐/泉园/马官桥/浑河站西
沈阳-东陵区-五三	浑河站西/马官桥/泉园/丰乐/浑河站东/白塔
沈阳-东陵区-前进	浑河站东/白塔/五三/浑河站西/马官桥/泉园
沈阳-东陵区-泉园	丰乐/马官桥/浑河站西/五三/桃仙/浑河站东
沈阳-东陵区-丰乐	泉园/马官桥/浑河站西/五三/桃仙/浑河站东
沈阳-东陵区-马官桥	浑河站西/泉园/五三/丰乐/浑河站东/桃仙
沈阳-东陵区-东湖	英达/东陵/丰乐/泉园/马官桥/浑河站西
沈阳-东陵区-浑河站西	马官桥/泉园/五三/丰乐/浑河站东/桃仙
沈阳-东陵区-桃仙	丰乐/泉园/浑河站西/马官桥/五三/白塔
沈阳-东陵区-浑河站东	白塔/五三/浑河站西/马官桥/前进/泉园
广州-白云-伍仙桥	广州大道北/梅花园/京溪/同和/南湖/永平
广州-白云-广花	机场路/新市/棠景/黄石/三元里/桂花岗
广州-白云-矿泉	棠景/桂花岗/同德围/新市/机场路/三元里
广州-白云-梅花园	广州大道北/伍仙桥/京溪/南湖/同和/永平
广州-白云-广园路	景泰/白云大道南/三元里/桂花岗/机场路/广花
广州-白云-京溪	同和/广州大道北/梅花园/伍仙桥/南湖/沙太北
广州-白云-松洲	太和/良田/沙太北/竹料/同和/南湖
广州-白云-均禾	黄边/黄石/新市/广花/嘉禾望岗/江高
广州-白云-竹料	良田/太和/松洲/人和/龙归/钟落潭
广州-白云-白云大道北	永平/嘉禾望岗/黄边/白云大道南/龙归/梅花园
广州-白云-同和	沙太北/京溪/南湖/广州大道北/梅花园/伍仙桥
广州-白云-神山	江高/石井/金沙洲/罗冲围/西槎路/同德围
广州-白云-景泰	广园路/三元里/白云大道南/桂花岗/机场路/广花
广州-白云-黄边	嘉禾望岗/黄石/白云大道南/白云大道北/均禾/广花
广州-白云-钟落潭	良田/竹料/松洲/太和/沙太北/南湖
广州-白云-新市	广花/机场路/棠景/黄石/三元里/桂花岗
广州-白云-棠景	机场路/新市/广花/矿泉/桂花岗/三元里
广州-白云-罗冲围	金沙洲/西槎路/同德围/石井/矿泉/棠景
广州-白云-良田	竹料/钟落潭/太和/松洲/沙太北/南湖
广州-白云-永平	白云大道北/嘉禾望岗/梅花园/南湖/龙归/广州大道北
广州-白云-人和	龙归/嘉禾望岗/永平/白云大道北/均禾/黄边
广州-白云-西槎路	同德围/罗冲围/石井/矿泉/棠景/新市
广州-白云-沙太北	同和/南湖/京溪/广州大道北/梅花园/伍仙桥
广州-白云-太和	松洲/竹料/良田/沙太北/南湖/龙归
广州-白云-三元里	桂花岗/景泰/广园路/机场路/棠景/广花
广州-白云-龙归	人和/永平/嘉禾望岗/白云大道北/南湖/黄边
广州-白云-南湖	京溪/同和/沙太北/梅花园/广州大道北/伍仙桥
广州-白云-机场路	广花/新市/棠景/黄石/三元里/桂花岗
广州-白云-嘉禾望岗	白云大道北/黄边/永平/龙归/白云大道南/黄石
广州-白云-黄石	广花/机场路/新市/黄边/白云大道南/三元里
广州-白云-白云大道南	景泰/广园路/三元里/黄石/黄边/机场路
广州-白云-九佛	钟落潭/良田/松洲/竹料/太和/沙太北
广州-白云-石井	同德围/西槎路/新市/棠景/广花/机场路
广州-白云-金沙洲	罗冲围/西槎路/同德围/石井/矿泉/棠景
广州-白云-桂花岗	三元里/棠景/景泰/矿泉/广园路/机场路
广州-白云-江高	石井/均禾/同德围/新市/西槎路/黄石
广州-白云-同德围	西槎路/石井/矿泉/罗冲围/棠景/新市
广州-白云-广州大道北	伍仙桥/梅花园/京溪/同和/南湖/永平
广州-番禺-黄阁	鱼窝头/东涌/石楼/石/灵山/大岗
广州-番禺-大岗	灵山/榄核/桥南/东环/鱼窝头/市桥
广州-番禺-东涌	鱼窝头/石/石楼/黄阁/灵山/大岗
广州-番禺-横沥	万顷沙/大石/洛溪/南浦/钟村/祈福
广州-番禺-市桥	桥南/沙头/华南/东环/祈福/榄核
广州-番禺-榄核	沙头/市桥/桥南/祈福/东环/大岗
广州-番禺-祈福	沙头/钟村/市桥/大石/横沥/万顷沙
广州-番禺-洛溪	南浦/大石/万顷沙/横沥/钟村/祈福
广州-番禺-鱼窝头	东涌/黄阁/石/灵山/石楼/大岗
广州-番禺-沙头	市桥/祈福/桥南/华南/东环/钟村
广州-番禺-石楼	东涌/石/鱼窝头/黄阁/灵山/大岗
广州-番禺-东环	华南/桥南/市桥/沙头/祈福/榄核
广州-番禺-华南	东环/桥南/市桥/沙头/祈福/钟村
广州-番禺-桥南	市桥/东环/华南/沙头/祈福/榄核
广州-番禺-万顷沙	横沥/大石/洛溪/南浦/钟村/祈福
广州-番禺-钟村	祈福/大石/横沥/万顷沙/南浦/洛溪
广州-番禺-石	东涌/鱼窝头/石楼/灵山/东环/华南
广州-番禺-灵山	大岗/鱼窝头/东涌/石/桥南/东环
广州-番禺-大石	横沥/万顷沙/洛溪/南浦/钟村/祈福
广州-番禺-南浦	洛溪/大石/万顷沙/横沥/钟村/祈福
广州-增城-正果	小楼/沙庄/荔城/三江/派潭/朱村
广州-增城-沙庄	荔城/小楼/三江/正果/派潭/仙村
广州-增城-派潭	小楼/荔城/沙庄/正果/朱村/三江
广州-增城-仙村	朱村/新塘/中新/福和/荔城/沙庄
广州-增城-新塘	永和/广园东/中新/镇龙/仙村/福和
广州-增城-镇龙	永和/中新/广园东/福和/新塘/朱村
广州-增城-小楼	荔城/沙庄/正果/派潭/三江/朱村
广州-增城-广园东	永和/新塘/镇龙/中新/福和/朱村
广州-增城-中新	福和/镇龙/永和/新塘/朱村/广园东
广州-增城-福和	中新/镇龙/朱村/永和/新塘/仙村
广州-增城-永和	广园东/新塘/镇龙/中新/福和/朱村
广州-增城-朱村	仙村/福和/中新/新塘/永和/荔城
广州-增城-荔城	沙庄/小楼/三江/派潭/正果/仙村
广州-增城-三江	沙庄/荔城/小楼/正果/派潭/仙村
广州-从化-太平	街口/城郊/江埔/温泉/鳌头/良口
广州-从化-街口	城郊/太平/江埔/温泉/鳌头/良口
广州-从化-城郊	街口/太平/江埔/温泉/鳌头/良口
广州-从化-江埔	太平/街口/城郊/温泉/良口/鳌头
广州-从化-鳌头	城郊/街口/太平/江埔/温泉/良口
广州-从化-吕田	良口/温泉/江埔/太平/城郊/街口
广州-从化-良口	温泉/江埔/太平/城郊/街口/吕田
广州-从化-温泉	江埔/城郊/太平/街口/良口/鳌头
广州-花都-炭步	赤坭/狮岭/新华/花城路/旧区/新区
广州-花都-雅瑶	花城路/旧区/新区/新华/芙蓉/花山
广州-花都-芙蓉	新区/旧区/花城路/新华/雅瑶/花山
广州-花都-旧区	新区/花城路/雅瑶/新华/芙蓉/花山
广州-花都-花侨	花东/北兴/梯面/花山/芙蓉/雅瑶
广州-花都-赤坭	炭步/狮岭/新华/花城路/新区/旧区
广州-花都-北兴	花侨/花东/梯面/花山/芙蓉/雅瑶
广州-花都-新区	旧区/花城路/新华/雅瑶/芙蓉/花山
广州-花都-狮岭	新华/花城路/新区/炭步/旧区/芙蓉
广州-花都-新华	花城路/旧区/新区/雅瑶/芙蓉/狮岭
广州-花都-花东	花侨/梯面/花山/北兴/芙蓉/旧区
广州-花都-梯面	花山/花东/芙蓉/花侨/新区/旧区
广州-花都-花城路	旧区/新区/新华/雅瑶/芙蓉/花山
广州-花都-花山	芙蓉/梯面/花东/新区/旧区/雅瑶
广州-天河-岗顶	龙口东/石牌/龙口西/天河东路/黄埔大道西/天河北
广州-天河-龙口西	天河东路/石牌/天河北/龙口东/黄埔大道西/岗顶
广州-天河-林和	粤垦/天河北/天河南/沙河/体育中心/兴华
广州-天河-天平架	沙东/沙河/沙太南/兴华/粤垦/体育中心
广州-天河-棠下	登峰/车陂/上社/天园/天河公园/东圃
广州-天河-华景新城	员村二横路/天河公园/员村/五山/上社/天园
广州-天河-沙河	沙东/天平架/兴华/沙太南/粤垦/林和
广州-天河-猎德	黄埔大道西/冼村/珠江新城/天河东路/石牌/天河南
广州-天河-植物园	龙洞/长兴/长/五山/元岗/华景新城
广州-天河-员村	员村二横路/天河公园/天园/华景新城/上社/五山
广州-天河-中山大道	黄村/前进/东圃/新塘/车陂/登峰
广州-天河-龙口东	岗顶/石牌/龙口西/天河东路/天河北/黄埔大道西
广州-天河-龙洞	植物园/长兴/长/凤凰/元岗/五山
广州-天河-黄埔大道西	天河东路/猎德/石牌/龙口西/天河北/冼村
广州-天河-天河东路	龙口西/黄埔大道西/天河北/石牌/龙口东/猎德
广州-天河-体育中心	体育西路/天河南/林和/天平架/珠江新城/沙河
广州-天河-元岗	天河客运站/长/长兴/五山/龙口东/岗顶
广州-天河-车陂	东圃/登峰/棠下/中山大道/黄村/前进
广州-天河-长兴	长/五山/元岗/天河客运站/植物园/华景新城
广州-天河-广州大道中	体育西路/体育中心/珠江新城/天河南/冼村/天平架
广州-天河-上社	天河公园/天园/员村/员村二横路/华景新城/棠下
广州-天河-石牌	龙口西/天河东路/黄埔大道西/龙口东/岗顶/天河北
广州-天河-冼村	珠江新城/天河南/猎德/黄埔大道西/体育西路/天河东路
广州-天河-沙东	沙河/天平架/沙太南/兴华/粤垦/林和
广州-天河-东圃	车陂/中山大道/前进/黄村/登峰/棠下
广州-天河-员村二横路	员村/天河公园/天园/华景新城/上社/五山
广州-天河-前进	中山大道/黄村/东圃/车陂/新塘/登峰
广州-天河-新塘	黄村/中山大道/前进/东圃/车陂/登峰
广州-天河-体育西路	体育中心/天河南/珠江新城/广州大道中/林和/冼村
广州-天河-天园	天河公园/上社/员村/员村二横路/华景新城/棠下
广州-天河-黄村	中山大道/前进/东圃/新塘/车陂/登峰
广州-天河-五山	长兴/长/华景新城/元岗/天河客运站/岗顶
广州-天河-天河南	珠江新城/冼村/林和/体育西路/黄埔大道西/天河北
广州-天河-珠吉	新塘/黄村/前进/中山大道/东圃/车陂
广州-天河-粤垦	兴华/林和/沙太南/沙河/沙东/天平架
广州-天河-登峰	棠下/车陂/东圃/上社/天园/天河公园
广州-天河-凤凰	龙洞/植物园/登峰/棠下/上社/新塘
广州-天河-天河公园	天园/上社/员村/员村二横路/华景新城/棠下
广州-天河-珠江新城	冼村/天河南/体育西路/猎德/体育中心/黄埔大道西
广州-天河-沙太南	兴华/沙东/沙河/粤垦/天平架/林和
广州-天河-天河客运站	元岗/长/五山/长兴/龙口东/龙口西
广州-天河-兴华	沙太南/粤垦/沙河/沙东/天平架/林和
广州-天河-长	长兴/元岗/五山/天河客运站/植物园/华景新城
广州-天河-天河北	天河东路/龙口西/林和/黄埔大道西/天河南/石牌
广州-越秀-水荫路	嘉禾/杨箕村/梅花村/五羊新城/东风东/农林下路
广州-越秀-盘福路	六榕/解放北/光塔/西门口/流花/解放南
广州-越秀-环市中	环市东/大东/洪桥/农讲所/东风路/小北
广州-越秀-大新	光塔/诗书/西门口/解放南/六榕/盘福路
广州-越秀-北京路	人民/广卫/小北/解放南/洪桥/农讲所
广州-越秀-六榕	盘福路/光塔/解放北/解放南/西门口/大新
广州-越秀-东湖	东川/大沙头/华乐/东山口/白云/建设
广州-越秀-西门口	光塔/诗书/大新/六榕/盘福路/解放南
广州-越秀-东川	东湖/东山口/大沙头/华乐/建设/东风路
广州-越秀-东山口	东风路/东川/建设/白云/大东/大沙头
广州-越秀-杨箕村	嘉禾/水荫路/五羊新城/梅花村/东风东/农林下路
广州-越秀-东风东	农林下路/梅花村/黄花岗/五羊新城/二沙岛/嘉禾
广州-越秀-淘金	华乐/建设/东风路/东川/东山口/环市东
广州-越秀-嘉禾	水荫路/杨箕村/梅花村/五羊新城/东风东/农林下路
广州-越秀-农林下路	东风东/黄花岗/梅花村/二沙岛/五羊新城/东湖
广州-越秀-洪桥	农讲所/小北/大东/环市中/环市东/北京路
广州-越秀-梅花村	五羊新城/东风东/农林下路/黄花岗/杨箕村/嘉禾
广州-越秀-白云	大沙头/东山口/大东/东风路/东川/农讲所
广州-越秀-解放北	盘福路/六榕/流花/广卫/光塔/西门口
广州-越秀-广卫	北京路/人民/小北/解放南/六榕/解放北
广州-越秀-华乐	建设/淘金/东川/东山口/东风路/东湖
广州-越秀-光塔	西门口/大新/诗书/六榕/盘福路/解放南
广州-越秀-二沙岛	农林下路/东湖/五羊新城/东风东/梅花村/黄花岗
广州-越秀-建设	华乐/东风路/东山口/淘金/东川/环市东
广州-越秀-小北	洪桥/广卫/北京路/农讲所/环市中/大东
广州-越秀-诗书	西门口/光塔/大新/六榕/盘福路/解放南
广州-越秀-黄花岗	农林下路/东风东/淘金/梅花村/华乐/二沙岛
广州-越秀-环市东	环市中/东风路/大东/建设/东山口/农讲所
广州-越秀-流花	解放北/盘福路/六榕/西门口/光塔/诗书
广州-越秀-人民	北京路/广卫/解放南/小北/六榕/洪桥
广州-越秀-大东	农讲所/东风路/洪桥/环市东/环市中/东山口
广州-越秀-东风路	东山口/建设/环市东/大东/环市中/白云
广州-越秀-大沙头	白云/东川/东湖/东山口/东风路/建设
广州-越秀-解放南	大新/六榕/人民/光塔/广卫/北京路
广州-越秀-五羊新城	梅花村/东风东/杨箕村/农林下路/二沙岛/嘉禾
广州-越秀-中山路	水荫路/杨箕村/嘉禾/五羊新城/梅花村/东风东
广州-越秀-农讲所	大东/洪桥/环市中/东风路/小北/环市东
广州-萝岗-开发东区	开发西区/萝岗镇/科学城
广州-萝岗-萝岗镇	开发东区/开发西区/科学城
广州-萝岗-科学城	萝岗镇/开发西区/开发东区
广州-萝岗-开发西区	开发东区/萝岗镇/科学城
广州-荔湾-昌华	黄沙/多宝/中山八路/逢源/南源/周门
广州-荔湾-坑口	芳村/花地湾/龙溪/白鹤洞/白鹅潭/沙面
广州-荔湾-龙溪	芳村/花地湾/坑口/黄沙/昌华/桥东
广州-荔湾-东风西	第一津街/光复北路/金花/站前/西华路/龙津
广州-荔湾-中山八路	南源/南岸路/昌华/黄沙/多宝/周门
广州-荔湾-多宝	逢源/昌华/黄沙/周门/中山八路/南源
广州-荔湾-周门	陈家祠/环市西/逢源/荔湾路/彩虹/多宝
广州-荔湾-陈家祠	荔湾路/彩虹/周门/逢源/西华路/华林
广州-荔湾-南岸路	南源/中山八路/昌华/黄沙/周门/多宝
广州-荔湾-沙面	白鹅潭/西关/华林/岭南/康王路/上下九
广州-荔湾-花地湾	芳村/坑口/龙溪/黄沙/昌华/白鹅潭
广州-荔湾-康王路	上下九/西关/岭南/华林/龙津/沙面
广州-荔湾-桥中	南岸路/桥东/窖口/南源/中山八路/昌华
广州-荔湾-南源	中山八路/南岸路/昌华/周门/黄沙/多宝
广州-荔湾-黄沙	昌华/多宝/中山八路/逢源/南源/周门
广州-荔湾-龙津	金花/上下九/康王路/华林/西华路/西关
广州-荔湾-站前	东风西/西村/第一津街/金花/西华路/光复北路
广州-荔湾-白鹅潭	沙面/西关/华林/岭南/康王路/逢源
广州-荔湾-岭南	康王路/上下九/西关/华林/龙津/沙面
广州-荔湾-西村	西华路/站前/彩虹/金花/荔湾路/环市西
广州-荔湾-黄岐	窖口/桥东/桥中/南岸路/龙溪/中山八路
广州-荔湾-上下九	康王路/西关/岭南/华林/龙津/沙面
广州-荔湾-西关	康王路/华林/上下九/岭南/龙津/沙面
广州-荔湾-白鹤洞	白鹅潭/沙面/坑口/岭南/康王路/西关
广州-荔湾-逢源	多宝/周门/陈家祠/昌华/黄沙/荔湾路
广州-荔湾-芳村	花地湾/坑口/龙溪/黄沙/昌华/白鹅潭
广州-荔湾-光复北路	第一津街/东风西/金花/龙津/西华路/上下九
广州-荔湾-华林	西关/康王路/上下九/岭南/龙津/沙面
广州-荔湾-环市西	周门/彩虹/荔湾路/陈家祠/西村/南源
广州-荔湾-金花	西华路/龙津/第一津街/光复北路/东风西/站前
广州-荔湾-彩虹	荔湾路/陈家祠/西华路/周门/环市西/西村
广州-荔湾-荔湾路	陈家祠/彩虹/西华路/周门/龙津/华林
广州-荔湾-西华路	金花/龙津/彩虹/荔湾路/西村/陈家祠
广州-荔湾-窖口	桥东/黄岐/桥中/南岸路/中山八路/龙溪
广州-荔湾-第一津街	东风西/光复北路/金花/站前/西华路/龙津
广州-荔湾-桥东	窖口/桥中/南岸路/龙溪/黄沙/中山八路
广州-海珠-滨江	前进路/素社/江南中/江南大道中/江南西/昌岗
广州-海珠-江南西	江南大道中/江南中/前进路/素社/昌岗/滨江
广州-海珠-海幢	南华西/宝岗/工业大道北/工业大道/龙凤/沙园
广州-海珠-客村	下渡路/广州大道南/新港西/赤岗/沥/江海
广州-海珠-滨江东	怡乐路/中大/新港/新港西/东晓/晓港
广州-海珠-官洲	华洲/琶洲/江海/赤岗/沥/客村
广州-海珠-晓港	凤阳/东晓/新港/瑞宝/江南大道南/昌岗
广州-海珠-新港西	下渡路/中大/滨江东/怡乐路/南洲/广州大道南
广州-海珠-下渡路	客村/新港西/广州大道南/中大/滨江东/怡乐路
广州-海珠-沙园	工业大道/宝岗/工业大道中/江南西/南石头/江南中
广州-海珠-中大	怡乐路/滨江东/新港/瑞宝/新港西/凤阳
广州-海珠-怡乐路	滨江东/中大/新港/瑞宝/晓港/东晓
广州-海珠-江南大道南	昌岗/江燕路/晓港/东晓/凤阳/江南大道中
广州-海珠-昌岗	江南大道南/江燕路/素社/江南大道中/前进路/江南西
广州-海珠-前进路	素社/江南大道中/江南中/江南西/滨江/昌岗
广州-海珠-瑞宝	凤阳/工业大道南/晓港/新港/中大/怡乐路
广州-海珠-江海	赤岗/琶洲/华洲/客村/沥/广州大道南
广州-海珠-龙凤	工业大道北/工业大道/南华西/海幢/宝岗/沙园
广州-海珠-素社	前进路/江南大道中/江南中/滨江/江南西/昌岗
广州-海珠-东晓	晓港/新港/昌岗/江南大道南/凤阳/素社
广州-海珠-南洲	工业大道南/瑞宝/中大/新港西/凤阳/怡乐路
广州-海珠-工业大道中	南石头/沙园/江燕路/江南西/昌岗/江南大道南
广州-海珠-南石头	工业大道中/江燕路/江南大道南/沙园/昌岗/江南西
广州-海珠-琶洲	江海/赤岗/华洲/客村/沥/广州大道南
广州-海珠-沥	广州大道南/客村/下渡路/江海/南洲/赤岗
广州-海珠-广州大道南	客村/沥/下渡路/新港西/南洲/赤岗
广州-海珠-新港	怡乐路/晓港/中大/凤阳/滨江东/东晓
广州-海珠-工业大道南	瑞宝/凤阳/南洲/晓港/江燕路/新港
广州-海珠-工业大道北	龙凤/南华西/工业大道/海幢/宝岗/沙园
广州-海珠-华洲	琶洲/江海/赤岗/官洲/沥/客村
广州-海珠-凤阳	晓港/瑞宝/新港/工业大道南/东晓/江南大道南
广州-海珠-南华西	海幢/工业大道北/龙凤/宝岗/工业大道/沙园
广州-海珠-江南大道中	江南西/江南中/前进路/素社/昌岗/滨江
广州-海珠-赤岗	江海/琶洲/客村/广州大道南/华洲/沥
广州-海珠-宝岗	海幢/工业大道/沙园/南华西/工业大道北/江南中
广州-海珠-江燕路	江南大道南/昌岗/南石头/晓港/工业大道中/凤阳
广州-海珠-工业大道	工业大道北/宝岗/龙凤/沙园/海幢/南华西
广州-海珠-江南中	江南大道中/江南西/前进路/素社/滨江/昌岗
广州-黄埔-黄埔区府	黄埔/大沙/文冲/红山/鱼珠/长洲
广州-黄埔-鱼珠	长洲/大沙/黄埔/黄埔区府/文冲/红山
广州-黄埔-荔联	南岗/穗东/红山/文冲/黄埔区府/黄埔
广州-黄埔-文冲	红山/黄埔区府/黄埔/大沙/穗东/鱼珠
广州-黄埔-南岗	荔联/穗东/红山/文冲/黄埔区府/黄埔
广州-黄埔-红山	文冲/黄埔区府/黄埔/大沙/穗东/鱼珠
广州-黄埔-穗东	南岗/荔联/红山/文冲/黄埔区府/黄埔
广州-黄埔-长洲	鱼珠/大沙/黄埔/黄埔区府/文冲/红山
广州-黄埔-大沙	黄埔/黄埔区府/鱼珠/文冲/红山/长洲
广州-黄埔-黄埔	大沙/黄埔区府/鱼珠/文冲/红山/长洲
深圳-龙岗-横岗	康桥/桂芳园/大芬村/可园/平湖/龙岗中心城
深圳-龙岗-大芬村	可园/桂芳园/康桥/龙珠花园/布吉/布吉关
深圳-龙岗-龙珠花园	布吉/布吉关/可园/大芬村/桂芳园/康桥
深圳-龙岗-布吉	龙珠花园/布吉关/可园/大芬村/桂芳园/康桥
深圳-龙岗-布吉关	布吉/龙珠花园/可园/大芬村/桂芳园/康桥
深圳-龙岗-南澳	葵涌/坪地/龙岗中心城/横岗/康桥/桂芳园
深圳-龙岗-桂芳园	康桥/大芬村/可园/龙珠花园/布吉/布吉关
深圳-龙岗-龙岗中心城	坪地/横岗/康桥/桂芳园/平湖/大芬村
深圳-龙岗-坂田	布吉/布吉关/龙珠花园/可园/平湖/大芬村
深圳-龙岗-葵涌	南澳/坪地/龙岗中心城/横岗/康桥/桂芳园
深圳-龙岗-坪地	龙岗中心城/横岗/葵涌/康桥/桂芳园/平湖
深圳-龙岗-康桥	桂芳园/大芬村/可园/龙珠花园/布吉/平湖
深圳-龙岗-可园	大芬村/桂芳园/龙珠花园/康桥/布吉/布吉关
深圳-龙岗-平湖	康桥/桂芳园/大芬村/可园/龙珠花园/布吉
深圳-罗湖-田贝	洪湖/翠竹/水贝/东门/独树村/文锦
深圳-罗湖-金稻田	华港新村/理想新城/独树村/草埔/水贝/田贝
深圳-罗湖-红岗花园	清水河/田心村/泥岗/笋岗/草埔/独树村
深圳-罗湖-笋岗	蔡屋围/红岗花园/田心村/清水河/泥岗/国贸
深圳-罗湖-东门	翠竹/文锦/田贝/洪湖/留医部/罗湖区委
深圳-罗湖-水库	东湖/东晓/黄贝岭/布心/留医部/罗湖区委
深圳-罗湖-文锦	留医部/罗湖区委/东门/文锦渡/田贝/翠竹
深圳-罗湖-火车站	国贸/人民南/东门/翠竹/洪湖/文锦渡
深圳-罗湖-莲塘	水库/东湖/东晓/黄贝岭/布心/罗湖区委
深圳-罗湖-东湖	水库/黄贝岭/东晓/布心/罗湖区委/留医部
深圳-罗湖-草埔	独树村/泥岗/金稻田/田心村/华港新村/清水河
深圳-罗湖-水贝	田贝/独树村/布心/洪湖/留医部/金稻田
深圳-罗湖-国贸	火车站/人民南/翠竹/东门/洪湖/蔡屋围
深圳-罗湖-华港新村	金稻田/理想新城/独树村/水贝/草埔/布心
深圳-罗湖-田心村	泥岗/红岗花园/洪湖/草埔/独树村/清水河
深圳-罗湖-洪湖	翠竹/田贝/东门/独树村/田心村/水贝
深圳-罗湖-银湖	笋岗/红岗花园/清水河/蔡屋围/田心村/泥岗
深圳-罗湖-清水河	红岗花园/泥岗/田心村/草埔/独树村/笋岗
深圳-罗湖-人民南	火车站/国贸/东门/翠竹/文锦渡/洪湖
深圳-罗湖-东晓	布心/水库/东湖/理想新城/水贝/留医部
深圳-罗湖-布心	东晓/水贝/理想新城/留医部/华港新村/文锦
深圳-罗湖-翠竹	洪湖/田贝/东门/火车站/国贸/文锦
深圳-罗湖-留医部	文锦/罗湖区委/东门/文锦渡/水贝/田贝
深圳-罗湖-罗湖区委	文锦/留医部/文锦渡/黄贝岭/东门/田贝
深圳-罗湖-文锦渡	罗湖区委/文锦/留医部/东门/黄贝岭/人民南
深圳-罗湖-独树村	草埔/金稻田/泥岗/田贝/水贝/洪湖
深圳-罗湖-黄贝岭	罗湖区委/东湖/文锦渡/留医部/文锦/水库
深圳-罗湖-泥岗	田心村/草埔/独树村/红岗花园/清水河/洪湖
深圳-罗湖-理想新城	华港新村/金稻田/布心/水贝/独树村/草埔
深圳-罗湖-蔡屋围	笋岗/国贸/火车站/人民南/田心村/红岗花园
深圳-福田-莲花一村	莲花二村/莲花三村/皇岗/福华新村/岗厦/彩田村
深圳-福田-购物公园	福田区委/新洲/石厦/中心区/莲花北村/景田
深圳-福田-莲花北村	下梅林/上梅林/彩田村/购物公园/景田/中心区
深圳-福田-中心区	购物公园/岗厦/福田区委/莲花三村/彩田村/福华新村
深圳-福田-下梅林	莲花北村/上梅林/彩田村/景田/中心区/购物公园
深圳-福田-沙尾	益田村/沙嘴/新洲/石厦/景田/上沙
深圳-福田-赤尾	华强南/华强北/白沙岭/黄木岗/上步/笔架山
深圳-福田-新洲	购物公园/景田/石厦/福田区委/益田村/莲花北村
深圳-福田-景田	新洲/莲花北村/购物公园/下梅林/沙尾/益田村
深圳-福田-福民新村	岗厦/福华新村/皇岗/中心区/莲花三村/莲花二村
深圳-福田-华强北	黄木岗/白沙岭/华强南/笔架山/赤尾/上步
深圳-福田-莲花三村	莲花二村/莲花一村/皇岗/岗厦/福华新村/中心区
深圳-福田-竹子林	车公庙/下沙/上沙/香蜜湖/沙嘴/沙尾
深圳-福田-白沙岭	华强北/上步/黄木岗/八卦岭/园岭/华强南
深圳-福田-香蜜湖	上沙/下沙/沙嘴/景田/沙尾/新洲
深圳-福田-园岭	八卦岭/上步/荔枝公园/白沙岭/华强北/黄木岗
深圳-福田-皇岗	福华新村/莲花二村/岗厦/莲花三村/莲花一村/福民新村
深圳-福田-莲花二村	莲花一村/莲花三村/皇岗/福华新村/岗厦/彩田村
深圳-福田-益田村	沙尾/沙嘴/石厦/新洲/福田区委/购物公园
深圳-福田-岗厦	福华新村/皇岗/福民新村/莲花三村/莲花二村/中心区
深圳-福田-上梅林	彩田村/下梅林/莲花北村/中心区/莲花三村/莲花一村
深圳-福田-荔枝公园	园岭/八卦岭/上步/白沙岭/华强北/华强南
深圳-福田-华强南	赤尾/华强北/白沙岭/黄木岗/上步/笔架山
深圳-福田-保税区	石厦/福田区委/购物公园/益田村/福民新村/中心区
深圳-福田-上步	八卦岭/园岭/白沙岭/荔枝公园/华强北/华强南
深圳-福田-笔架山	黄木岗/华强北/白沙岭/莲花一村/莲花二村/华强南
深圳-福田-沙嘴	沙尾/益田村/上沙/香蜜湖/下沙/新洲
深圳-福田-彩田村	上梅林/下梅林/莲花北村/中心区/莲花三村/莲花一村
深圳-福田-福田区委	石厦/购物公园/保税区/中心区/新洲/益田村
深圳-福田-黄木岗	华强北/笔架山/白沙岭/华强南/赤尾/上步
深圳-福田-上沙	下沙/香蜜湖/沙嘴/沙尾/益田村/车公庙
深圳-福田-八卦岭	园岭/上步/白沙岭/荔枝公园/华强北/黄木岗
深圳-福田-车公庙	竹子林/下沙/上沙/香蜜湖/沙嘴/沙尾
深圳-福田-福华新村	岗厦/皇岗/福民新村/莲花三村/莲花二村/莲花一村
深圳-福田-石厦	福田区委/保税区/购物公园/益田村/新洲/中心区
深圳-福田-下沙	上沙/香蜜湖/沙嘴/车公庙/竹子林/沙尾
深圳-南山-后海	南油/中心区/海王大厦/区政府/蛇口/桂庙路口
深圳-南山-南头	南新路口/南山医院/桂庙路口/海王大厦/区政府/南油
深圳-南山-深大北门	区政府/中心区/科技园/南油/后海/南山医院
深圳-南山-华侨城	桃源村/白石洲/大冲/科技园/深圳湾/深大北门
深圳-南山-南油	海王大厦/后海/区政府/桂庙路口/中心区/南山医院
深圳-南山-区政府	南油/南山医院/海王大厦/深大北门/桂庙路口/中心区
深圳-南山-海王大厦	南油/桂庙路口/南山医院/后海/区政府/南头
深圳-南山-蛇口	招商大厦/海上世界/后海/海王大厦/南油/桂庙路口
深圳-南山-中心区	后海/南油/深大北门/区政府/海王大厦/桂庙路口
深圳-南山-桂庙路口	南山医院/海王大厦/南头/南油/南新路口/区政府
深圳-南山-深圳湾	中心区/后海/南油/科技园/蛇口/深大北门
深圳-南山-招商大厦	蛇口/海上世界/海王大厦/后海/桂庙路口/南油
深圳-南山-前海	南头/桂庙路口/南新路口/海上世界/招商大厦/南山医院
深圳-南山-南新路口	南头/南山医院/桂庙路口/区政府/海王大厦/南油
深圳-南山-南山医院	桂庙路口/南新路口/南头/区政府/海王大厦/南油
深圳-南山-西丽	南新路口/南头/前海/南山医院/桂庙路口/区政府
深圳-南山-白石洲	大冲/华侨城/桃源村/科技园/深圳湾/深大北门
深圳-南山-科技园	大冲/深大北门/中心区/区政府/白石洲/南油
深圳-南山-桃源村	华侨城/白石洲/大冲/科技园/深圳湾/深大北门
深圳-南山-大冲	科技园/白石洲/深大北门/中心区/深圳湾/区政府
深圳-南山-海上世界	招商大厦/蛇口/海王大厦/前海/桂庙路口/后海
深圳-盐田-小梅沙	大梅沙/盐田/沙头角
深圳-盐田-盐田	沙头角/大梅沙/小梅沙
深圳-盐田-沙头角	盐田/大梅沙/小梅沙
深圳-盐田-大梅沙	小梅沙/盐田/沙头角
深圳-宝安-石岩	中心区/万科城/翻身路/新安/锦绣江南/西乡
深圳-宝安-万科城	中心区/石岩/翻身路/新安/新中心区/锦绣江南
深圳-宝安-新安	翻身路/新中心区/西乡/中心区/桃源居/万科城
深圳-宝安-滢水山庄	梅林关口/潜龙花园/民治/龙华/锦绣江南/美丽365花园
深圳-宝安-桃源居	西乡/新中心区/新安/翻身路/福永/中心区
深圳-宝安-潜龙花园	民治/滢水山庄/梅林关口/锦绣江南/龙华/美丽365花园
深圳-宝安-观澜	龙华/美丽365花园/民治/锦绣江南/潜龙花园/滢水山庄
深圳-宝安-西乡	新中心区/桃源居/新安/翻身路/中心区/福永
深圳-宝安-美丽365花园	龙华/锦绣江南/民治/潜龙花园/滢水山庄/观澜
深圳-宝安-民治	潜龙花园/滢水山庄/锦绣江南/梅林关口/龙华/美丽365花园
深圳-宝安-中心区	翻身路/新安/新中心区/西乡/万科城/石岩
深圳-宝安-福永	沙井/桃源居/松岗/西乡/新中心区/新安
深圳-宝安-梅林关口	滢水山庄/潜龙花园/民治/锦绣江南/龙华/美丽365花园
深圳-宝安-松岗	沙井/福永/桃源居/西乡/新中心区/新安
深圳-宝安-锦绣江南	美丽365花园/龙华/民治/潜龙花园/滢水山庄/梅林关口
深圳-宝安-沙井	福永/松岗/桃源居/西乡/新中心区/新安
深圳-宝安-翻身路	新安/新中心区/西乡/中心区/桃源居/万科城
深圳-宝安-龙华	美丽365花园/锦绣江南/民治/潜龙花园/滢水山庄/观澜
深圳-宝安-新中心区	西乡/新安/翻身路/桃源居/中心区/福永
重庆-万州区-龙驹	长滩/恒合土家族/太安/白羊/罗田/梨树
重庆-万州区-天城	周家坝/高笋塘/钟鼓楼/牌楼/太白/陈家坝
重庆-万州区-龙沙	响水/武陵/双河口/新镇/柱山/李河
重庆-万州区-长滩	白羊/黄柏/龙驹/太安/罗田/太龙
重庆-万州区-长岭	茨竹/大周/五桥/小周/百安坝/太龙
重庆-万州区-大周	小周/太龙/长岭/五桥/百安坝/茨竹
重庆-万州区-弹子	后山/余家/孙家/分水/郭村/响水
重庆-万州区-地宝	白土/普子/凤仪/梨树/恒合土家族/太安
重庆-万州区-沙河	太白/周家坝/九池/高笋塘/天城/牌楼
重庆-万州区-高梁	柱山/李河/九池/沙河/双河口/高峰
重庆-万州区-渡	甘宁/燕山/溪口/新镇/高峰/柱山
重庆-万州区-双河口	李河/响水/龙沙/柱山/高梁/郭村
重庆-万州区-茨竹	长岭/五桥/走马/百安坝/大周/罗田
重庆-万州区-分水	孙家/后山/郭村/响水/弹子/双河口
重庆-万州区-太安	白羊/长滩/龙驹/梨树/黄柏/恒合土家族
重庆-万州区-周家坝	天城/太白/高笋塘/沙河/牌楼/钟鼓楼
重庆-万州区-凤仪	梨树/恒合土家族/普子/白土/龙驹/太安
重庆-万州区-钟鼓楼	牌楼/高笋塘/天城/陈家坝/周家坝/太白
重庆-万州区-长坪	武陵/新镇/龙沙/燕山/甘宁/渡
重庆-万州区-龙都	陈家坝/新田/百安坝/钟鼓楼/牌楼/高笋塘
重庆-万州区-高笋塘	牌楼/钟鼓楼/天城/太白/周家坝/陈家坝
重庆-万州区-郭村	响水/龙沙/武陵/双河口/长坪/分水
重庆-万州区-小周	太龙/大周/长岭/黄柏/五桥/茨竹
重庆-万州区-太龙	小周/大周/黄柏/长岭/白羊/长滩
重庆-万州区-五桥	百安坝/龙都/长岭/熊家/陈家坝/新田
重庆-万州区-太白	高笋塘/周家坝/沙河/牌楼/天城/钟鼓楼
重庆-万州区-李河	高梁/柱山/双河口/龙沙/响水/九池
重庆-万州区-白土	普子/凤仪/地宝/梨树/恒合土家族/太安
重庆-万州区-走马	新田/茨竹/百安坝/五桥/龙都/长岭
重庆-万州区-普子	白土/凤仪/地宝/梨树/恒合土家族/太安
重庆-万州区-黄柏	白羊/太龙/长滩/小周/太安/大周
重庆-万州区-孙家	后山/弹子/分水/余家/郭村/响水
重庆-万州区-高峰	九池/太白/沙河/溪口/高笋塘/牌楼
重庆-万州区-恒合土家族	梨树/凤仪/龙驹/太安/白土/普子
重庆-万州区-梨树	恒合土家族/凤仪/太安/龙驹/白土/普子
重庆-万州区-甘宁	渡/燕山/溪口/新镇/高峰/柱山
重庆-万州区-白羊	长滩/黄柏/太安/龙驹/太龙/小周
重庆-万州区-溪口	甘宁/渡/燕山/高峰/九池/新镇
重庆-万州区-后山	弹子/孙家/余家/分水/郭村/响水
重庆-万州区-新田	龙都/陈家坝/百安坝/牌楼/钟鼓楼/高笋塘
重庆-万州区-铁峰	熊家/天城/钟鼓楼/陈家坝/周家坝/牌楼
重庆-万州区-柱山	高梁/李河/甘宁/渡/九池/龙沙
重庆-万州区-燕山	渡/甘宁/溪口/新镇/武陵/长坪
重庆-万州区-牌楼	高笋塘/钟鼓楼/天城/陈家坝/太白/周家坝
重庆-万州区-罗田	长滩/茨竹/龙驹/长岭/白羊/走马
重庆-万州区-百安坝	五桥/龙都/陈家坝/熊家/新田/长岭
重庆-万州区-武陵	长坪/新镇/龙沙/燕山/响水/渡
重庆-万州区-响水	郭村/龙沙/双河口/武陵/李河/长坪
重庆-万州区-余家	弹子/后山/孙家/分水/郭村/响水
重庆-万州区-九池	高峰/沙河/太白/周家坝/高笋塘/牌楼
重庆-万州区-陈家坝	钟鼓楼/龙都/牌楼/高笋塘/天城/太白
重庆-万州区-熊家	铁峰/陈家坝/龙都/百安坝/钟鼓楼/五桥
重庆-万州区-新镇	武陵/长坪/燕山/渡/甘宁/龙沙
重庆-渝中区-观音岩	大溪沟/七星岗/一号桥/南纪门/两路口/较场口
重庆-渝中区-王家坡	菜园坝/上清寺/李子坝/两路口/黄沙溪/大溪沟
重庆-渝中区-一号桥	七星岗/南纪门/观音岩/较场口/大溪沟/解放碑
重庆-渝中区-大溪沟	观音岩/七星岗/一号桥/两路口/南纪门/上清寺
重庆-渝中区-七星岗	一号桥/观音岩/南纪门/较场口/大溪沟/解放碑
重庆-渝中区-较场口	南纪门/解放碑/一号桥/七星岗/望龙门/朝天门
重庆-渝中区-望龙门	朝天门/解放碑/较场口/南纪门/一号桥/七星岗
重庆-渝中区-袁家岗	大坪/化龙桥/黄沙溪/李子坝/王家坡/菜园坝
重庆-渝中区-朝天门	望龙门/解放碑/较场口/南纪门/一号桥/七星岗
重庆-渝中区-化龙桥	袁家岗/大坪/黄沙溪/李子坝/王家坡/菜园坝
重庆-渝中区-黄沙溪	大坪/李子坝/袁家岗/王家坡/菜园坝/上清寺
重庆-渝中区-李子坝	王家坡/菜园坝/上清寺/黄沙溪/两路口/大坪
重庆-渝中区-菜园坝	王家坡/上清寺/两路口/李子坝/黄沙溪/大溪沟
重庆-渝中区-解放碑	较场口/南纪门/望龙门/朝天门/一号桥/七星岗
重庆-渝中区-上清寺	两路口/王家坡/菜园坝/李子坝/大溪沟/观音岩
重庆-渝中区-南纪门	较场口/解放碑/一号桥/七星岗/望龙门/朝天门
重庆-渝中区-两路口	上清寺/菜园坝/王家坡/大溪沟/观音岩/李子坝
重庆-渝中区-大坪	袁家岗/黄沙溪/化龙桥/李子坝/王家坡/菜园坝
重庆-渝北区-石坪	沙坪/双龙湖/双凤桥/王家/木耳/两路
重庆-渝北区-龙溪	加洲新牌坊/花卉园/人和/冉家坝/龙头寺/新溉路
重庆-渝北区-沙坪	石坪/木耳/王家/双凤桥/双龙湖/两路
重庆-渝北区-冉家坝	花卉园/大竹林/加洲新牌坊/龙溪/礼嘉/人和
重庆-渝北区-王家	玉峰山/沙坪/兴隆/石坪/木耳/双凤桥
重庆-渝北区-双龙湖	双凤桥/两路/一碗水/回兴/木耳/沙坪
重庆-渝北区-张关	洛碛/麻柳沱/大盛/明月/统景/石船
重庆-渝北区-洛碛	张关/麻柳沱/大盛/明月/统景/石船
重庆-渝北区-石船	御临/统景/龙兴/高嘴/麻柳沱/古路
重庆-渝北区-御临	石船/龙兴/统景/高嘴/麻柳沱/古路
重庆-渝北区-大湾	高嘴/统景/明月/石船/古路/茨竹
重庆-渝北区-玉峰山	王家/兴隆/古路/沙坪/石坪/龙兴
重庆-渝北区-悦来	鸳鸯/人和/龙头寺/新溉路/汽博中心/龙溪
重庆-渝北区-汽博中心	鸳鸯/农业园区/新溉路/龙头寺/悦来/人和
重庆-渝北区-统景	石船/麻柳沱/御临/大湾/明月/高嘴
重庆-渝北区-双凤桥	双龙湖/两路/一碗水/回兴/木耳/沙坪
重庆-渝北区-大盛	明月/麻柳沱/张关/洛碛/统景/石船
重庆-渝北区-新溉路	龙头寺/人和/鸳鸯/汽博中心/龙溪/加洲新牌坊
重庆-渝北区-高嘴	古路/大湾/茨竹/石船/统景/龙兴
重庆-渝北区-人和	龙溪/加洲新牌坊/龙头寺/新溉路/花卉园/鸳鸯
重庆-渝北区-中河	华蓥山/茨竹/兴隆/古路/高嘴/王家
重庆-渝北区-加洲新牌坊	花卉园/龙溪/人和/冉家坝/礼嘉/龙头寺
重庆-渝北区-华蓥山	中河/茨竹/兴隆/古路/高嘴/王家
重庆-渝北区-礼嘉	大竹林/冉家坝/加洲新牌坊/花卉园/龙溪/人和
重庆-渝北区-龙头寺	新溉路/人和/鸳鸯/汽博中心/龙溪/加洲新牌坊
重庆-渝北区-明月	大盛/麻柳沱/统景/张关/洛碛/大湾
重庆-渝北区-农业园区	汽博中心/回兴/一碗水/两路/鸳鸯/双龙湖
重庆-渝北区-回兴	一碗水/两路/双龙湖/双凤桥/农业园区/汽博中心
重庆-渝北区-麻柳沱	大盛/张关/明月/统景/洛碛/石船
重庆-渝北区-两路	一碗水/双龙湖/回兴/双凤桥/农业园区/木耳
重庆-渝北区-木耳	沙坪/双凤桥/双龙湖/两路/一碗水/石坪
重庆-渝北区-花卉园	加洲新牌坊/龙溪/冉家坝/人和/礼嘉/大竹林
重庆-渝北区-鸳鸯	汽博中心/龙头寺/新溉路/悦来/人和/农业园区
重庆-渝北区-古路	高嘴/茨竹/龙兴/玉峰山/兴隆/石船
重庆-渝北区-茨竹	中河/华蓥山/兴隆/古路/高嘴/王家
重庆-渝北区-大竹林	冉家坝/礼嘉/花卉园/加洲新牌坊/龙溪/人和
重庆-渝北区-一碗水	两路/回兴/双龙湖/双凤桥/农业园区/木耳
重庆-渝北区-兴隆	王家/中河/华蓥山/茨竹/玉峰山/沙坪
重庆-渝北区-龙兴	御临/石船/古路/高嘴/统景/玉峰山
重庆-长寿区-葛兰	新市/渡舟/石堰/但渡/凤城/双龙
重庆-长寿区-海棠	云台/龙河/石堰/双龙/邻封/长寿湖
重庆-长寿区-双龙	龙河/邻封/石堰/云台/海棠/但渡
重庆-长寿区-凤城	渡舟/江南/八颗/新市/但渡/晏家
重庆-长寿区-长寿湖	云集/龙河/邻封/双龙/海棠/云台
重庆-长寿区-云台	海棠/石堰/龙河/双龙/邻封/葛兰
重庆-长寿区-八颗	晏家/江南/凤城/渡舟/万顺/洪湖
重庆-长寿区-新市	葛兰/渡舟/但渡/凤城/石堰/双龙
重庆-长寿区-云集	长寿湖/邻封/龙河/双龙/海棠/云台
重庆-长寿区-晏家	八颗/江南/万顺/洪湖/凤城/渡舟
重庆-长寿区-邻封	双龙/龙河/石堰/云集/云台/长寿湖
重庆-长寿区-但渡	新市/渡舟/葛兰/凤城/双龙/邻封
重庆-长寿区-江南	凤城/八颗/晏家/渡舟/新市/万顺
重庆-长寿区-万顺	洪湖/八颗/晏家/江南/凤城/渡舟
重庆-长寿区-洪湖	万顺/晏家/八颗/江南/凤城/渡舟
重庆-长寿区-龙河	双龙/邻封/云台/海棠/石堰/长寿湖
重庆-长寿区-渡舟	凤城/新市/江南/但渡/八颗/葛兰
重庆-长寿区-石堰	云台/双龙/龙河/葛兰/海棠/新市
重庆-黔江区-中塘	舟白/县坝/联合/正阳/南海/邻鄂
重庆-黔江区-学堂	石家河/鹅池/新华/杨柳/石钟/渗坝
重庆-黔江区-白合	九龙/工农/石会/白石/杉岭/沙坝
重庆-黔江区-小庄	马喇/金洞/五里/早化/蓬东/邻鄂
重庆-黔江区-联合	正阳/冯家坝/南海/青冈/舟白/中塘
重庆-黔江区-九龙	白合/白石/黄溪/新民/工农/石会
重庆-黔江区-黑溪	白石/西泡/九龙/白合/沙坝/新民
重庆-黔江区-沙坝	西泡/工农/石会/白合/九龙/新华
重庆-黔江区-蓬东	五里/邻鄂/舟白/正阳/冯家坝/马喇
重庆-黔江区-工农	石会/白合/沙坝/西泡/九龙/白石
重庆-黔江区-鹅池	学堂/渗坝/石家河/新华/杨柳/石钟
重庆-黔江区-县坝	舟白/中塘/邻鄂/五里/蓬东/正阳
重庆-黔江区-渗坝	鹅池/石家河/学堂/新华/石钟/沙坝
重庆-黔江区-石会	工农/白合/九龙/沙坝/西泡/杉岭
重庆-黔江区-后坝	栅山/平溪/黎水/杉岭/南海/石会
重庆-黔江区-栅山	平溪/后坝/金溪/青冈/白土/太极
重庆-黔江区-五里	蓬东/邻鄂/马喇/舟白/小庄/正阳
重庆-黔江区-西泡	沙坝/工农/黑溪/白合/九龙/石会
重庆-黔江区-犁弯	濯水/两河/濯西/蒲花/早化/寨子
重庆-黔江区-杉岭	黄溪/新花/黎水/新民/九龙/白合
重庆-黔江区-南海	联合/中塘/青冈/后坝/正阳/水田
重庆-黔江区-正阳	冯家坝/联合/舟白/蓬东/寨子/五里
重庆-黔江区-石家河	学堂/新华/鹅池/石钟/渗坝/杨柳
重庆-黔江区-新安	杨柳/水市/太极/金溪/白土/学堂
重庆-黔江区-邻鄂	五里/蓬东/舟白/县坝/马喇/小庄
重庆-黔江区-水田	青冈/寨子/蒲花/濯西/金溪/濯水
重庆-黔江区-新民	黄溪/新花/白石/杉岭/九龙/白合
重庆-黔江区-白土	石钟/平溪/新华/太极/金溪/新安
重庆-黔江区-黄溪	新民/新花/杉岭/九龙/白石/白合
重庆-黔江区-冯家坝	正阳/寨子/濯水/蓬东/联合/蒲花
重庆-黔江区-两河	犁弯/濯西/蒲花/水市/濯水/寨子
重庆-黔江区-石钟	新华/白土/石家河/平溪/学堂/太极
重庆-黔江区-金洞	小庄/马喇/早化/五里/蓬东/邻鄂
重庆-黔江区-太极	金溪/水市/新安/白土/平溪/杨柳
重庆-黔江区-金溪	太极/平溪/水田/栅山/青冈/水市
重庆-黔江区-水市	新安/太极/杨柳/濯西/金溪/两河
重庆-黔江区-舟白	邻鄂/蓬东/正阳/五里/县坝/中塘
重庆-黔江区-寨子	水田/蒲花/濯水/濯西/青冈/冯家坝
重庆-黔江区-青冈	水田/寨子/蒲花/金溪/联合/冯家坝
重庆-黔江区-濯水	蒲花/寨子/犁弯/濯西/冯家坝/水田
重庆-黔江区-平溪	白土/栅山/金溪/太极/石钟/石会
重庆-黔江区-马喇	小庄/金洞/五里/蓬东/邻鄂/早化
重庆-黔江区-新花	新民/黄溪/杉岭/黎水/白石/九龙
重庆-黔江区-濯西	蒲花/寨子/濯水/水田/犁弯/两河
重庆-黔江区-黎水	杉岭/黄溪/新花/新民/后坝/九龙
重庆-黔江区-杨柳	新安/水市/太极/学堂/石家河/白土
重庆-黔江区-白石	九龙/黑溪/新民/白合/黄溪/新花
重庆-黔江区-新华	石钟/石家河/白土/学堂/沙坝/渗坝
重庆-黔江区-蒲花	濯西/寨子/濯水/水田/犁弯/冯家坝
重庆-黔江区-早化	金洞/小庄/犁弯/马喇/濯水/两河
重庆-南岸区-广阳	迎龙/峡口/长生桥/南山/茶园新区/鸡冠石
重庆-南岸区-峡口	长生桥/南山/茶园新区/迎龙/鸡冠石/黄桷桠
重庆-南岸区-南滨路	龙门浩/海棠溪/大佛段/玄坛庙/涂山/黄桷桠
重庆-南岸区-弹子石	经开区/南坪/花园路/回龙湾/四公里/学府大道
重庆-南岸区-学府大道	回龙湾/四公里/南坪/弹子石/经开区/海棠溪
重庆-南岸区-龙门浩	南滨路/海棠溪/玄坛庙/大佛段/涂山/黄桷桠
重庆-南岸区-海棠溪	南滨路/龙门浩/大佛段/四公里/玄坛庙/涂山
重庆-南岸区-南山	茶园新区/鸡冠石/黄桷桠/玄坛庙/涂山/龙门浩
重庆-南岸区-迎龙	峡口/长生桥/广阳/南山/茶园新区/鸡冠石
重庆-南岸区-大佛段	南滨路/龙门浩/涂山/玄坛庙/海棠溪/黄桷桠
重庆-南岸区-南坪	弹子石/回龙湾/经开区/四公里/学府大道/花园路
重庆-南岸区-长生桥	峡口/茶园新区/南山/迎龙/鸡冠石/黄桷桠
重庆-南岸区-四公里	回龙湾/学府大道/南坪/弹子石/经开区/海棠溪
重庆-南岸区-经开区	弹子石/花园路/南坪/回龙湾/四公里/学府大道
重庆-南岸区-鸡冠石	涂山/玄坛庙/黄桷桠/南山/龙门浩/南滨路
重庆-南岸区-玄坛庙	涂山/南滨路/龙门浩/黄桷桠/大佛段/鸡冠石
重庆-南岸区-回龙湾	学府大道/四公里/南坪/弹子石/经开区/花园路
重庆-南岸区-黄桷桠	玄坛庙/涂山/龙门浩/南滨路/鸡冠石/海棠溪
重庆-南岸区-铜元局	花园路/经开区/弹子石/南坪/回龙湾/学府大道
重庆-南岸区-涂山	玄坛庙/南滨路/大佛段/龙门浩/黄桷桠/鸡冠石
重庆-南岸区-茶园新区	南山/黄桷桠/鸡冠石/玄坛庙/涂山/龙门浩
重庆-南岸区-花园路	经开区/弹子石/铜元局/南坪/回龙湾/学府大道
重庆-北碚区-蔡家岗	施家梁/童家溪/东阳/朝阳/天府/水土
重庆-北碚区-澄江	城南新区/城北新区/北温泉/歇马/龙凤桥/水土
重庆-北碚区-施家梁	蔡家岗/天府/东阳/童家溪/朝阳/水土
重庆-北碚区-复兴	静观/柳荫/天府/三圣/石坝/施家梁
重庆-北碚区-金刀峡	偏岩/石坝/柳荫/三圣/静观/复兴
重庆-北碚区-水土	朝阳/龙凤桥/北温泉/城北新区/东阳/城南新区
重庆-北碚区-龙凤桥	水土/朝阳/北温泉/城北新区/东阳/城南新区
重庆-北碚区-朝阳	水土/龙凤桥/东阳/北温泉/城北新区/施家梁
重庆-北碚区-天府	施家梁/蔡家岗/东阳/朝阳/水土/复兴
重庆-北碚区-三圣	石坝/柳荫/金刀峡/偏岩/静观/复兴
重庆-北碚区-天生	三圣/偏岩/石坝/金刀峡/柳荫/复兴
重庆-北碚区-城南新区	澄江/城北新区/北温泉/歇马/龙凤桥/水土
重庆-北碚区-歇马	城南新区/澄江/城北新区/北温泉/龙凤桥/水土
重庆-北碚区-城北新区	北温泉/龙凤桥/水土/朝阳/东阳/城南新区
重庆-北碚区-东阳	朝阳/水土/龙凤桥/北温泉/城北新区/施家梁
重庆-北碚区-柳荫	三圣/石坝/金刀峡/静观/偏岩/复兴
重庆-北碚区-偏岩	金刀峡/石坝/三圣/柳荫/静观/复兴
重庆-北碚区-石坝	三圣/柳荫/金刀峡/偏岩/静观/复兴
重庆-北碚区-静观	复兴/柳荫/三圣/天府/石坝/金刀峡
重庆-北碚区-北温泉	城北新区/龙凤桥/水土/朝阳/东阳/城南新区
重庆-北碚区-童家溪	蔡家岗/施家梁/龙凤桥/朝阳/水土/东阳
重庆-巴南区-惠民	南彭/二圣/天星寺/跳石/界石/接龙
重庆-巴南区-一品	安澜/南泉/李家沱/鱼洞/界石/花溪
重庆-巴南区-花溪	南泉/李家沱/鱼洞/一品/界石/安澜
重庆-巴南区-麻柳嘴	双河口/丰盛/木洞/东泉/石龙/姜家
重庆-巴南区-李家沱	南泉/鱼洞/花溪/一品/安澜/界石
重庆-巴南区-界石	安澜/南彭/一品/跳石/花溪/南泉
重庆-巴南区-天星寺	二圣/接龙/姜家/惠民/东泉/木洞
重庆-巴南区-石龙	石滩/东泉/姜家/丰盛/木洞/接龙
重庆-巴南区-安澜	一品/界石/跳石/花溪/南泉/李家沱
重庆-巴南区-南彭	跳石/界石/惠民/安澜/一品/天星寺
重庆-巴南区-南泉	李家沱/鱼洞/花溪/一品/安澜/界石
重庆-巴南区-木洞	东泉/姜家/二圣/双河口/丰盛/石龙
重庆-巴南区-跳石	南彭/界石/安澜/惠民/一品/花溪
重庆-巴南区-姜家	东泉/接龙/二圣/天星寺/木洞/石龙
重庆-巴南区-石滩	石龙/东泉/姜家/接龙/丰盛/木洞
重庆-巴南区-丰盛	双河口/麻柳嘴/东泉/石龙/木洞/石滩
重庆-巴南区-东泉	木洞/姜家/石龙/丰盛/双河口/石滩
重庆-巴南区-鱼洞	李家沱/南泉/花溪/一品/安澜/界石
重庆-巴南区-接龙	天星寺/姜家/二圣/东泉/石滩/石龙
重庆-巴南区-双河口	丰盛/麻柳嘴/东泉/木洞/石龙/姜家
重庆-巴南区-二圣	天星寺/姜家/惠民/接龙/木洞/东泉
重庆-万盛区-南桐	南天/金桥/青年/万东/东林/关坝
重庆-万盛区-南天	万东/东林/南桐/景星/青年/金桥
重庆-万盛区-景星	东林/丛林/万东/南天/南桐/金桥
重庆-万盛区-关坝	青年/南桐/南天/金桥/万东/东林
重庆-万盛区-万东	东林/南天/景星/南桐/丛林/金桥
重庆-万盛区-金桥	南桐/万东/南天/东林/青年/丛林
重庆-万盛区-丛林	景星/东林/万东/南天/南桐/金桥
重庆-万盛区-东林	万东/景星/南天/丛林/南桐/金桥
重庆-万盛区-青年	关坝/南桐/南天/金桥/万东/东林
重庆-江北区-寸滩	江北城/五里店/黄泥磅/华新街/观音桥/北滨路
重庆-江北区-铁山坪	鱼嘴/江北城/寸滩/五里店/复盛/黄泥磅
重庆-江北区-鱼嘴	复盛/铁山坪/五宝/江北城/寸滩/五里店
重庆-江北区-江北城	寸滩/五里店/黄泥磅/华新街/观音桥/北滨路
重庆-江北区-五宝	复盛/鱼嘴/铁山坪/江北城/寸滩/五里店
重庆-江北区-北滨路	红旗河沟/华新街/观音桥/黄泥磅/五里店/大石坝
重庆-江北区-郭家沱	南桥寺/石马河/大石坝/红旗河沟/北滨路/观音桥
重庆-江北区-华新街	观音桥/黄泥磅/北滨路/红旗河沟/五里店/寸滩
重庆-江北区-五里店	寸滩/江北城/黄泥磅/华新街/观音桥/北滨路
重庆-江北区-大石坝	石马河/南桥寺/郭家沱/红旗河沟/北滨路/观音桥
重庆-江北区-观音桥	华新街/黄泥磅/北滨路/红旗河沟/五里店/寸滩
重庆-江北区-石马河	南桥寺/大石坝/郭家沱/红旗河沟/北滨路/观音桥
重庆-江北区-南桥寺	石马河/大石坝/郭家沱/红旗河沟/北滨路/观音桥
重庆-江北区-黄泥磅	观音桥/华新街/红旗河沟/北滨路/五里店/寸滩
重庆-江北区-红旗河沟	北滨路/观音桥/华新街/黄泥磅/大石坝/五里店
重庆-江北区-复盛	鱼嘴/五宝/铁山坪/江北城/寸滩/五里店
重庆-涪陵区-白涛	山窝/南沱/清溪/江东/敦仁/珍溪
重庆-涪陵区-明家	新妙/龙潭/两汇/增福/石沱/镇安
重庆-涪陵区-龙桥	李渡/石龙/致韩/龙塘/马武/酒店
重庆-涪陵区-堡子	蔺市/青羊/镇安/同乐/石沱/义和
重庆-涪陵区-石龙	龙塘/致韩/李渡/龙桥/丛林/江北
重庆-涪陵区-马武	酒店/龙桥/李渡/江北/石龙/致韩
重庆-涪陵区-蔺市	堡子/义和/青羊/惠民/镇安/同乐
重庆-涪陵区-南沱	清溪/珍溪/江东/敦仁/百胜/白涛
重庆-涪陵区-百胜	荔枝/崇义/敦仁/江北/丛林/江东
重庆-涪陵区-罗云	焦石/仁义/卷洞/山窝/中峰/白涛
重庆-涪陵区-丛林	江北/百胜/龙塘/石龙/崇义/荔枝
重庆-涪陵区-青羊	同乐/堡子/蔺市/惠民/义和/镇安
重庆-涪陵区-两汇	石沱/新妙/明家/龙潭/镇安/堡子
重庆-涪陵区-卷洞	焦石/罗云/山窝/仁义/中峰/白涛
重庆-涪陵区-江东	敦仁/荔枝/崇义/百胜/清溪/南沱
重庆-涪陵区-石沱	镇安/两汇/堡子/蔺市/义和/龙潭
重庆-涪陵区-龙塘	石龙/李渡/致韩/龙桥/丛林/江北
重庆-涪陵区-清溪	南沱/珍溪/江东/敦仁/百胜/荔枝
重庆-涪陵区-镇安	石沱/堡子/蔺市/两汇/义和/青羊
重庆-涪陵区-敦仁	荔枝/江东/崇义/百胜/江北/酒店
重庆-涪陵区-义和	蔺市/惠民/堡子/致韩/青羊/镇安
重庆-涪陵区-致韩	石龙/李渡/龙桥/龙塘/义和/惠民
重庆-涪陵区-龙潭	明家/两汇/新妙/堡子/石沱/同乐
重庆-涪陵区-江北	酒店/崇义/荔枝/百胜/丛林/敦仁
重庆-涪陵区-焦石	卷洞/罗云/山窝/仁义/中峰/白涛
重庆-涪陵区-仁义	罗云/焦石/中峰/卷洞/山窝/珍溪
重庆-涪陵区-荔枝	崇义/敦仁/百胜/江北/江东/酒店
重庆-涪陵区-新妙	明家/两汇/增福/龙潭/石沱/镇安
重庆-涪陵区-崇义	荔枝/敦仁/百胜/江北/江东/酒店
重庆-涪陵区-惠民	义和/蔺市/青羊/堡子/同乐/致韩
重庆-涪陵区-山窝	卷洞/焦石/罗云/白涛/仁义/中峰
重庆-涪陵区-中峰	仁义/罗云/珍溪/焦石/南沱/清溪
重庆-涪陵区-酒店	江北/马武/崇义/荔枝/龙桥/李渡
重庆-涪陵区-同乐	青羊/堡子/蔺市/惠民/义和/镇安
重庆-涪陵区-珍溪	清溪/南沱/江东/中峰/敦仁/百胜
重庆-涪陵区-李渡	龙桥/石龙/致韩/龙塘/马武/酒店
重庆-涪陵区-增福	明家/新妙/两汇/龙潭/石沱/镇安
重庆-双桥区-龙滩子	通桥/双路
重庆-双桥区-通桥	双路/龙滩子
重庆-双桥区-双路	通桥/龙滩子
重庆-沙坪坝区-陈家桥	凤凰/大学城/青木关/土主/曾家/西永
重庆-沙坪坝区-西永	土主/回龙坝/中梁/陈家桥/歌乐山/山洞
重庆-沙坪坝区-凤天路	虎溪/覃家岗/天星桥/渝碚路/三峡广场/沙坪坝
重庆-沙坪坝区-井口	双碑/詹家溪/石井坡/磁器口/童家桥/杨公桥
重庆-沙坪坝区-渝碚路	劳动路/三峡广场/虎溪/沙坪坝/覃家岗/沙正街
重庆-沙坪坝区-歌乐山	山洞/中梁/童家桥/新桥/石井坡/双碑
重庆-沙坪坝区-小龙坎	工人村/汉渝路/沙坪坝/土湾/三峡广场/沙正街
重庆-沙坪坝区-沙滨路	汉渝路/土湾/工人村/小龙坎/沙正街/沙坪坝
重庆-沙坪坝区-杨公桥	磁器口/天星桥/童家桥/覃家岗/渝碚路/劳动路
重庆-沙坪坝区-磁器口	杨公桥/詹家溪/劳动路/渝碚路/石井坡/天星桥
重庆-沙坪坝区-三峡广场	沙坪坝/沙正街/渝碚路/小龙坎/工人村/劳动路
重庆-沙坪坝区-覃家岗	天星桥/凤天路/虎溪/渝碚路/杨公桥/劳动路
重庆-沙坪坝区-土主	西永/回龙坝/陈家桥/中梁/歌乐山/山洞
重庆-沙坪坝区-詹家溪	双碑/石井坡/磁器口/井口/杨公桥/童家桥
重庆-沙坪坝区-青木关	凤凰/大学城/陈家桥/曾家/土主/西永
重庆-沙坪坝区-沙坪坝	三峡广场/沙正街/小龙坎/渝碚路/工人村/劳动路
重庆-沙坪坝区-曾家	大学城/青木关/陈家桥/凤凰/土主/西永
重庆-沙坪坝区-虎溪	凤天路/覃家岗/天星桥/渝碚路/三峡广场/沙坪坝
重庆-沙坪坝区-石井坡	双碑/詹家溪/童家桥/磁器口/杨公桥/井口
重庆-沙坪坝区-天星桥	覃家岗/凤天路/虎溪/渝碚路/杨公桥/劳动路
重庆-沙坪坝区-中梁	歌乐山/山洞/井口/双碑/石井坡/童家桥
重庆-沙坪坝区-土湾	汉渝路/沙滨路/工人村/小龙坎/沙坪坝/三峡广场
重庆-沙坪坝区-汉渝路	沙滨路/土湾/工人村/小龙坎/沙坪坝/沙正街
重庆-沙坪坝区-凤凰	青木关/大学城/陈家桥/曾家/土主/回龙坝
重庆-沙坪坝区-双碑	石井坡/詹家溪/井口/童家桥/磁器口/杨公桥
重庆-沙坪坝区-工人村	小龙坎/汉渝路/土湾/沙滨路/沙坪坝/三峡广场
重庆-沙坪坝区-回龙坝	土主/西永/中梁/陈家桥/歌乐山/山洞
重庆-沙坪坝区-新桥	童家桥/杨公桥/天星桥/覃家岗/凤天路/虎溪
重庆-沙坪坝区-劳动路	渝碚路/沙正街/三峡广场/沙坪坝/磁器口/覃家岗
重庆-沙坪坝区-童家桥	石井坡/杨公桥/双碑/磁器口/詹家溪/新桥
重庆-沙坪坝区-沙正街	沙坪坝/三峡广场/劳动路/渝碚路/小龙坎/工人村
重庆-沙坪坝区-山洞	歌乐山/新桥/童家桥/中梁/石井坡/双碑
重庆-沙坪坝区-大学城	曾家/青木关/凤凰/陈家桥/土主/西永
重庆-九龙坡区-杨家坪	谢家湾/渝州路/陈家坪/石坪桥/黄桷坪/石桥铺
重庆-九龙坡区-白市驿	含谷/石板/中梁山/陶家/巴福/金凤
重庆-九龙坡区-渝州路	陈家坪/石坪桥/石桥铺/杨家坪/谢家湾/二郎
重庆-九龙坡区-黄桷坪	华岩/九龙/谢家湾/杨家坪/渝州路/石坪桥
重庆-九龙坡区-陶家	石板/巴福/西彭/铜罐驿/白市驿/含谷
重庆-九龙坡区-谢家湾	杨家坪/渝州路/黄桷坪/陈家坪/石坪桥/九龙
重庆-九龙坡区-二郎	石桥铺/石坪桥/陈家坪/渝州路/杨家坪/谢家湾
重庆-九龙坡区-石板	陶家/白市驿/含谷/巴福/中梁山/铜罐驿
重庆-九龙坡区-巴福	陶家/西彭/石板/金凤/走马/白市驿
重庆-九龙坡区-中梁山	白市驿/含谷/石板/铜罐驿/陶家/二郎
重庆-九龙坡区-石桥铺	陈家坪/石坪桥/渝州路/二郎/杨家坪/谢家湾
重庆-九龙坡区-金凤	走马/巴福/白市驿/石板/含谷/陶家
重庆-九龙坡区-走马	金凤/巴福/西彭/陶家/石板/白市驿
重庆-九龙坡区-含谷	白市驿/石板/中梁山/陶家/巴福/金凤
重庆-九龙坡区-华岩	九龙/黄桷坪/谢家湾/杨家坪/渝州路/陈家坪
重庆-九龙坡区-陈家坪	渝州路/石坪桥/石桥铺/杨家坪/二郎/谢家湾
重庆-九龙坡区-石坪桥	陈家坪/渝州路/石桥铺/杨家坪/二郎/谢家湾
重庆-九龙坡区-铜罐驿	陶家/石板/中梁山/西彭/白市驿/巴福
重庆-九龙坡区-九龙	华岩/黄桷坪/谢家湾/杨家坪/渝州路/陈家坪
重庆-九龙坡区-西彭	巴福/陶家/石板/走马/铜罐驿/金凤
重庆-大渡口区-九宫庙	新山村/步行街/茄子溪/八桥/春晖路/跃进村
重庆-大渡口区-八桥	春晖路/步行街/茄子溪/九宫庙/新山村/跃进村
重庆-大渡口区-建胜	跃进村/新山村/九宫庙/茄子溪/步行街/八桥
重庆-大渡口区-跳磴	春晖路/八桥/茄子溪/步行街/九宫庙/新山村
重庆-大渡口区-步行街	八桥/春晖路/茄子溪/九宫庙/新山村/跃进村
重庆-大渡口区-跃进村	新山村/九宫庙/步行街/茄子溪/八桥/春晖路
重庆-大渡口区-春晖路	八桥/步行街/茄子溪/九宫庙/新山村/跃进村
重庆-大渡口区-茄子溪	八桥/步行街/春晖路/九宫庙/新山村/跃进村
重庆-大渡口区-新山村	九宫庙/跃进村/步行街/茄子溪/八桥/春晖路
上海-浦东-南码头	六里/周家渡/塘桥/东明路/上南新村/世博滨江
上海-浦东-世博滨江	上钢新村/上南新村/周家渡/南码头/东明路/六里
上海-浦东-花木	世纪公园/北蔡/杨东/东方路地铁/联洋/源深竹园
上海-浦东-张江	碧云/金桥/金杨新村/唐镇/浦东外环/高行
上海-浦东-金杨新村	碧云/金桥/联洋/洋泾/世纪公园/高行
上海-浦东-三林	上南新村/周家渡/东明路/上钢新村/世博滨江/六里
上海-浦东-上钢新村	世博滨江/上南新村/周家渡/东明路/三林/南码头
上海-浦东-潍坊	八佰伴/梅园/东方路地铁/东昌站地铁/塘桥/源深竹园
上海-浦东-杨东	东方路地铁/花木/塘桥/六里/潍坊/源深竹园
上海-浦东-八佰伴	潍坊/东昌站地铁/梅园/塘桥/东方路地铁/源深竹园
上海-浦东-唐镇	浦东外环/曹路/张江/川沙/高行/金桥
上海-浦东-东昌站地铁	八佰伴/潍坊/陆家嘴/梅园/塘桥/东方路地铁
上海-浦东-川沙	唐镇/曹路/浦东外环/张江/高行/金桥
上海-浦东-上南新村	周家渡/上钢新村/世博滨江/东明路/南码头/三林
上海-浦东-外高桥	高桥/高行/金桥/金杨新村/碧云/洋泾
上海-浦东-浦东外环	曹路/唐镇/高行/张江/金桥/碧云
上海-浦东-源深竹园	梅园/潍坊/东方路地铁/八佰伴/洋泾/杨东
上海-浦东-联洋	世纪公园/洋泾/花木/北蔡/金杨新村/源深竹园
上海-浦东-高行	金桥/外高桥/碧云/金杨新村/浦东外环/高桥
上海-浦东-东明路	周家渡/六里/上南新村/南码头/上钢新村/世博滨江
上海-浦东-周家渡	上南新村/东明路/世博滨江/南码头/上钢新村/六里
上海-浦东-洋泾	联洋/世纪公园/源深竹园/花木/梅园/东方路地铁
上海-浦东-东方路地铁	杨东/塘桥/潍坊/八佰伴/源深竹园/梅园
上海-浦东-碧云	金桥/金杨新村/联洋/张江/高行/世纪公园
上海-浦东-世纪公园	联洋/花木/洋泾/北蔡/源深竹园/杨东
上海-浦东-六里	东明路/南码头/塘桥/周家渡/杨东/东方路地铁
上海-浦东-曹路	浦东外环/唐镇/川沙/高行/张江/金桥
上海-浦东-高桥	外高桥/高行/金杨新村/金桥/碧云/洋泾
上海-浦东-陆家嘴	东昌站地铁/八佰伴/潍坊/梅园/塘桥/南码头
上海-浦东-北蔡	花木/世纪公园/杨东/联洋/东方路地铁/洋泾
上海-浦东-金桥	碧云/金杨新村/高行/张江/联洋/世纪公园
上海-浦东-塘桥	东方路地铁/潍坊/八佰伴/南码头/六里/东昌站地铁
上海-浦东-梅园	潍坊/源深竹园/八佰伴/东昌站地铁/东方路地铁/塘桥
上海-黄浦区-南京东路	外滩/豫园/人民广场/老西门/西藏南路/蓬莱公园
上海-黄浦区-蓬莱公园	半淞园路/黄浦滨江/西藏南路/南外滩/董家渡/豫园
上海-黄浦区-南外滩	董家渡/黄浦滨江/半淞园路/蓬莱公园/豫园/西藏南路
上海-黄浦区-老西门	西藏南路/豫园/南京东路/外滩/人民广场/蓬莱公园
上海-黄浦区-豫园	外滩/老西门/西藏南路/南京东路/蓬莱公园/董家渡
上海-黄浦区-西藏南路	老西门/蓬莱公园/豫园/半淞园路/外滩/南京东路
上海-黄浦区-黄浦滨江	半淞园路/蓬莱公园/南外滩/董家渡/西藏南路/豫园
上海-黄浦区-董家渡	南外滩/黄浦滨江/半淞园路/蓬莱公园/豫园/西藏南路
上海-黄浦区-人民广场	南京东路/老西门/外滩/西藏南路/豫园/蓬莱公园
上海-黄浦区-半淞园路	黄浦滨江/蓬莱公园/南外滩/董家渡/西藏南路/豫园
上海-黄浦区-外滩	豫园/南京东路/老西门/西藏南路/人民广场/蓬莱公园
上海-闵行区-七宝	航华/龙柏金汇/漕宝路/静安新城/莘庄/华漕
上海-闵行区-古美罗阳	梅陇/春申/漕宝路/静安新城/莘庄/虹桥
上海-闵行区-梅陇	春申/古美罗阳/金虹桥/虹桥/漕宝路/静安新城
上海-闵行区-虹桥	金虹桥/静安新城/漕宝路/龙柏金汇/古美罗阳/梅陇
上海-闵行区-江川路	老闵行/颛桥/吴泾/马桥/春申/莘庄
上海-闵行区-航华	龙柏金汇/七宝/静安新城/漕宝路/虹桥/金虹桥
上海-闵行区-吴泾	老闵行/浦江/江川路/颛桥/春申/梅陇
上海-闵行区-静安新城	漕宝路/虹桥/龙柏金汇/金虹桥/古美罗阳/航华
上海-闵行区-颛桥	春申/老闵行/莘庄/古美罗阳/马桥/江川路
上海-闵行区-漕宝路	静安新城/虹桥/龙柏金汇/金虹桥/古美罗阳/航华
上海-闵行区-金虹桥	虹桥/静安新城/漕宝路/古美罗阳/龙柏金汇/梅陇
上海-闵行区-马桥	颛桥/莘庄/老闵行/江川路/春申/古美罗阳
上海-闵行区-华漕	航华/七宝/龙柏金汇/静安新城/漕宝路/虹桥
上海-闵行区-浦江	吴泾/老闵行/梅陇/江川路/春申/颛桥
上海-闵行区-龙柏金汇	航华/静安新城/漕宝路/虹桥/七宝/金虹桥
上海-闵行区-老闵行	江川路/颛桥/吴泾/春申/马桥/梅陇
上海-闵行区-莘庄	古美罗阳/漕宝路/静安新城/春申/颛桥/七宝
上海-闵行区-春申	梅陇/古美罗阳/颛桥/莘庄/漕宝路/静安新城
上海-长宁区-中山公园	周家桥/新华路/江苏路地铁/虹桥/上海影城/天山路
上海-长宁区-程家桥	动物园/北新泾/古北/仙霞新村/天山路/虹桥
上海-长宁区-古北	仙霞新村/天山路/虹桥/周家桥/程家桥/北新泾
上海-长宁区-仙霞新村	古北/天山路/周家桥/虹桥/北新泾/程家桥
上海-长宁区-上海影城	新华路/江苏路地铁/镇宁路/中山公园/虹桥/周家桥
上海-长宁区-天山路	仙霞新村/周家桥/古北/虹桥/中山公园/新华路
上海-长宁区-动物园	程家桥/北新泾/仙霞新村/古北/天山路/周家桥
上海-长宁区-北新泾	程家桥/动物园/仙霞新村/古北/天山路/周家桥
上海-长宁区-虹桥	周家桥/天山路/新华路/中山公园/古北/上海影城
上海-长宁区-周家桥	中山公园/天山路/虹桥/新华路/仙霞新村/古北
上海-长宁区-江苏路地铁	镇宁路/上海影城/新华路/中山公园/周家桥/虹桥
上海-长宁区-镇宁路	江苏路地铁/上海影城/新华路/中山公园/周家桥/虹桥
上海-长宁区-新华路	上海影城/中山公园/江苏路地铁/虹桥/镇宁路/周家桥
上海-杨浦区-黄兴	五角场/新华医院/控江路/周家嘴路/鞍山/杨浦公园
上海-杨浦区-鞍山	新华医院/周家嘴路/四平路/黄兴/复旦大学/五角场
上海-杨浦区-新华医院	周家嘴路/鞍山/黄兴/控江路/四平路/长阳路
上海-杨浦区-五角场	黄兴/复旦大学/新华医院/鞍山/中原/控江路
上海-杨浦区-四平路	鞍山/复旦大学/新华医院/周家嘴路/黄兴/五角场
上海-杨浦区-控江路	杨浦公园/长阳路/黄兴/周家嘴路/东外滩/平凉路
上海-杨浦区-复旦大学	四平路/鞍山/五角场/黄兴/新华医院/新江湾城
上海-杨浦区-平凉路	东外滩/杨浦大桥/长阳路/杨浦公园/控江路/长白新村
上海-杨浦区-中原	五角场/黄兴/长白新村/杨浦公园/控江路/长阳路
上海-杨浦区-东外滩	平凉路/长阳路/杨浦大桥/杨浦公园/控江路/长白新村
上海-杨浦区-长白新村	杨浦公园/平凉路/控江路/杨浦大桥/东外滩/长阳路
上海-杨浦区-长阳路	东外滩/控江路/杨浦公园/平凉路/周家嘴路/杨浦大桥
上海-杨浦区-新江湾城	复旦大学/五角场/黄兴/四平路/中原/鞍山
上海-杨浦区-杨浦大桥	平凉路/东外滩/长阳路/杨浦公园/长白新村/控江路
上海-杨浦区-周家嘴路	新华医院/鞍山/黄兴/控江路/长阳路/杨浦公园
上海-杨浦区-杨浦公园	控江路/长阳路/平凉路/东外滩/长白新村/黄兴
上海-卢湾区-新天地	复兴公园/打浦桥/五里桥/鲁班路/淮海中路/世博滨江
上海-卢湾区-世博滨江	五里桥/鲁班路/新天地/打浦桥/复兴公园/淮海中路
上海-卢湾区-打浦桥	复兴公园/鲁班路/淮海中路/新天地/五里桥/世博滨江
上海-卢湾区-复兴公园	淮海中路/打浦桥/新天地/鲁班路/五里桥/世博滨江
上海-卢湾区-鲁班路	打浦桥/五里桥/世博滨江/新天地/复兴公园/淮海中路
上海-卢湾区-五里桥	世博滨江/鲁班路/新天地/打浦桥/复兴公园/淮海中路
上海-卢湾区-淮海中路	复兴公园/打浦桥/新天地/鲁班路/五里桥/世博滨江
上海-奉贤区-庄行	西渡/南桥/柘林/金汇/海湾旅游区/海湾
上海-奉贤区-南桥	西渡/柘林/金汇/庄行/海湾旅游区/海湾
上海-奉贤区-金汇	南桥/西渡/海湾/柘林/海湾旅游区/庄行
上海-奉贤区-西渡	南桥/庄行/金汇/柘林/海湾旅游区/海湾
上海-奉贤区-奉城	海湾/海湾旅游区/金汇/柘林/南桥/西渡
上海-奉贤区-海湾旅游区	海湾/柘林/南桥/金汇/西渡/庄行
上海-奉贤区-柘林	南桥/海湾旅游区/海湾/西渡/庄行/金汇
上海-奉贤区-海湾	海湾旅游区/柘林/南桥/金汇/西渡/奉城
上海-金山区-金山新城	石化/金山卫/漕泾/亭林/金山中部/朱泾
上海-金山区-朱泾	金山中部/枫泾/亭林/金山卫/石化/金山新城
上海-金山区-枫泾	朱泾/金山中部/亭林/金山卫/石化/金山新城
上海-金山区-亭林	金山新城/金山卫/金山中部/石化/漕泾/朱泾
上海-金山区-金山中部	朱泾/亭林/金山卫/石化/金山新城/漕泾
上海-金山区-石化	金山卫/金山新城/漕泾/亭林/金山中部/朱泾
上海-金山区-漕泾	金山新城/石化/金山卫/亭林/金山中部/朱泾
上海-金山区-金山卫	石化/金山新城/亭林/漕泾/金山中部/朱泾
上海-嘉定区-安亭	新城/嘉定镇/菊园新区/嘉定城区/马陆/南翔
上海-嘉定区-嘉定城区	嘉定镇/菊园新区/新城/马陆/南翔/江桥
上海-嘉定区-嘉定镇	菊园新区/嘉定城区/新城/马陆/南翔/安亭
上海-嘉定区-新城	嘉定城区/嘉定镇/马陆/菊园新区/南翔/安亭
上海-嘉定区-马陆	新城/嘉定城区/嘉定镇/南翔/菊园新区/江桥
上海-嘉定区-丰庄	真新新村/江桥/南翔/马陆/新城/嘉定城区
上海-嘉定区-菊园新区	嘉定镇/嘉定城区/新城/马陆/南翔/安亭
上海-嘉定区-江桥	丰庄/南翔/真新新村/马陆/新城/嘉定城区
上海-嘉定区-南翔	江桥/马陆/丰庄/真新新村/新城/嘉定城区
上海-嘉定区-真新新村	丰庄/江桥/南翔/马陆/新城/嘉定城区
上海-青浦区-赵巷	重固/青浦北部/青浦新城/徐泾/白鹤/朱家角
上海-青浦区-朱家角	青浦新城/白鹤/重固/赵巷/青浦北部/徐泾
上海-青浦区-青浦北部	重固/赵巷/徐泾/白鹤/青浦新城/朱家角
上海-青浦区-重固	赵巷/青浦北部/白鹤/青浦新城/徐泾/朱家角
上海-青浦区-青浦新城	白鹤/重固/赵巷/朱家角/青浦北部/徐泾
上海-青浦区-白鹤	重固/青浦新城/赵巷/青浦北部/朱家角/徐泾
上海-青浦区-徐泾	青浦北部/赵巷/重固/白鹤/青浦新城/朱家角
上海-崇明县-崇明新城	城桥/崇明/堡镇/长兴岛/陈家镇/横沙岛
上海-崇明县-堡镇	长兴岛/陈家镇/崇明新城/城桥/崇明/横沙岛
上海-崇明县-陈家镇	横沙岛/长兴岛/堡镇/崇明新城/城桥/崇明
上海-崇明县-长兴岛	堡镇/陈家镇/横沙岛/崇明新城/城桥/崇明
上海-崇明县-城桥	崇明/崇明新城/堡镇/长兴岛/陈家镇/横沙岛
上海-崇明县-崇明	城桥/崇明新城/堡镇/长兴岛/陈家镇/横沙岛
上海-崇明县-横沙岛	陈家镇/长兴岛/堡镇/崇明新城/城桥/崇明
上海-宝山区-庙行	共康/通河新村/张庙/共富/泗塘/杨行
上海-宝山区-淞宝	东城区/友谊路/淞南/高境/通河西城区/泗塘
上海-宝山区-淞南	高境/东城区/泗塘/张庙/淞宝/友谊路
上海-宝山区-高境	淞南/泗塘/张庙/东城区/通河新村/共康
上海-宝山区-共富	庙行/通河新村/杨行/共康/张庙/泗塘
上海-宝山区-杨行	通河西城区/通河新村/共富/张庙/庙行/泗塘
上海-宝山区-友谊路	东城区/淞宝/通河西城区/淞南/泗塘/杨行
上海-宝山区-大华	大场/上大/共康/庙行/共富/顾村
上海-宝山区-共康	庙行/通河新村/张庙/共富/泗塘/杨行
上海-宝山区-张庙	泗塘/通河新村/庙行/共康/杨行/共富
上海-宝山区-上大	顾村/大场/大华/共富/共康/庙行
上海-宝山区-东城区	淞宝/友谊路/淞南/高境/泗塘/通河西城区
上海-宝山区-吴淞	大华/大场/上大/共康/庙行/顾村
上海-宝山区-泗塘	张庙/通河新村/庙行/共康/高境/杨行
上海-宝山区-通河新村	张庙/庙行/共康/泗塘/共富/杨行
上海-宝山区-通河西城区	杨行/友谊路/月浦/通河新村/泗塘/张庙
上海-宝山区-罗店	罗泾/顾村/上大/月浦/共富/大场
上海-宝山区-月浦	杨行/通河西城区/共富/通河新村/顾村/张庙
上海-宝山区-罗泾	罗店/顾村/月浦/上大/共富/杨行
上海-宝山区-顾村	上大/共富/大场/大华/庙行/共康
上海-宝山区-大场	大华/上大/共康/庙行/共富/顾村
上海-虹口区-四平路	临平路/曲阳路/鲁迅公园/北外滩/四川北路/周家嘴路
上海-虹口区-四川北路	鲁迅公园/四平路/北外滩/临平路/曲阳路/周家嘴路
上海-虹口区-大柏树	曲阳路/江湾/鲁迅公园/四平路/临平路/凉城
上海-虹口区-提篮桥	周家嘴路/和平公园/北外滩/临平路/四平路/曲阳路
上海-虹口区-江湾	大柏树/凉城/曲阳路/鲁迅公园/广中路/四平路
上海-虹口区-鲁迅公园	四平路/曲阳路/四川北路/大柏树/临平路/北外滩
上海-虹口区-周家嘴路	北外滩/临平路/和平公园/提篮桥/四平路/曲阳路
上海-虹口区-广中路	凉城/鲁迅公园/江湾/四川北路/大柏树/曲阳路
上海-虹口区-临平路	周家嘴路/北外滩/四平路/和平公园/曲阳路/提篮桥
上海-虹口区-曲阳路	大柏树/四平路/鲁迅公园/临平路/和平公园/周家嘴路
上海-虹口区-凉城	广中路/江湾/大柏树/鲁迅公园/曲阳路/四平路
上海-虹口区-和平公园	周家嘴路/临平路/提篮桥/北外滩/四平路/曲阳路
上海-虹口区-北外滩	周家嘴路/临平路/四平路/和平公园/提篮桥/四川北路
上海-闸北区-和田	闸北公园/共和新路/芷江西路/延长路/新客站/西藏北路
上海-闸北区-老北站	宝山路/西藏北路/和田/芷江西路/闸北公园/共和新路
上海-闸北区-宝山路	老北站/西藏北路/和田/闸北公园/芷江西路/共和新路
上海-闸北区-延长路	大宁路/共和新路/闸北公园/和田/芷江西路/新客站
上海-闸北区-新客站	芷江西路/天目西路/共和新路/和田/西藏北路/延长路
上海-闸北区-西藏北路	老北站/宝山路/芷江西路/和田/新客站/共和新路
上海-闸北区-彭浦	汶水路/大宁路/延长路/闸北公园/共和新路/和田
上海-闸北区-芷江西路	共和新路/和田/新客站/闸北公园/延长路/天目西路
上海-闸北区-大宁路	延长路/共和新路/闸北公园/汶水路/和田/芷江西路
上海-闸北区-闸北公园	共和新路/和田/延长路/芷江西路/大宁路/新客站
上海-闸北区-汶水路	彭浦/大宁路/延长路/闸北公园/共和新路/和田
上海-闸北区-天目西路	新客站/芷江西路/共和新路/延长路/和田/大宁路
上海-闸北区-共和新路	闸北公园/延长路/和田/芷江西路/大宁路/新客站
上海-静安区-北京西路	南京西路/江宁路/新闸路/静安寺/西康路/曹家渡
上海-静安区-曹家渡	西康路/静安寺/南京西路/江宁路/北京西路/新闸路
上海-静安区-南京西路	北京西路/江宁路/静安寺/新闸路/西康路/曹家渡
上海-静安区-江宁路	北京西路/南京西路/新闸路/西康路/静安寺/曹家渡
上海-静安区-新闸路	北京西路/江宁路/南京西路/西康路/静安寺/曹家渡
上海-静安区-静安寺	西康路/南京西路/江宁路/北京西路/新闸路/曹家渡
上海-静安区-西康路	静安寺/江宁路/南京西路/北京西路/新闸路/曹家渡
上海-南汇区-周浦	康桥/航头/新场/祝桥/惠南/泥城
上海-南汇区-泥城	临港新城/惠南/祝桥/新场/航头/周浦
上海-南汇区-新场	航头/周浦/康桥/惠南/祝桥/泥城
上海-南汇区-惠南	祝桥/泥城/新场/临港新城/航头/周浦
上海-南汇区-航头	周浦/康桥/新场/祝桥/惠南/泥城
上海-南汇区-临港新城	泥城/惠南/祝桥/新场/航头/周浦
上海-南汇区-康桥	周浦/航头/新场/祝桥/惠南/泥城
上海-南汇区-祝桥	惠南/新场/泥城/航头/临港新城/周浦
上海-徐汇区-湖南路	衡山路/徐家汇/交大/万体馆/淮海西路/肇嘉浜路
上海-徐汇区-漕宝路地铁	漕河泾/上海南站/万体馆/徐家汇/衡山路/上师大
上海-徐汇区-交大	徐家汇/淮海西路/衡山路/湖南路/万体馆/漕宝路地铁
上海-徐汇区-上海南站	漕河泾/华东理工/漕宝路地铁/上师大/凌云路/长桥
上海-徐汇区-长桥	植物园/上海南站/华东理工/华泾/漕宝路地铁/漕河泾
上海-徐汇区-植物园	长桥/华泾/龙华/漕宝路地铁/上海南站/万体馆
上海-徐汇区-枫林路	肇嘉浜路/斜土路/复兴中路/龙华/万体馆/衡山路
上海-徐汇区-龙华	万体馆/枫林路/肇嘉浜路/植物园/斜土路/衡山路
上海-徐汇区-徐家汇	衡山路/交大/湖南路/万体馆/淮海西路/漕宝路地铁
上海-徐汇区-田林	上师大/康健/漕河泾/上海南站/华东理工/漕宝路地铁
上海-徐汇区-衡山路	徐家汇/万体馆/交大/湖南路/淮海西路/肇嘉浜路
上海-徐汇区-肇嘉浜路	枫林路/复兴中路/斜土路/万体馆/湖南路/衡山路
上海-徐汇区-凌云路	华东理工/康健/上海南站/上师大/田林/漕河泾
上海-徐汇区-康健	上师大/凌云路/田林/华东理工/上海南站/漕河泾
上海-徐汇区-淮海西路	交大/徐家汇/衡山路/湖南路/万体馆/漕宝路地铁
上海-徐汇区-华东理工	凌云路/上海南站/康健/上师大/漕河泾/长桥
上海-徐汇区-上师大	田林/康健/漕河泾/上海南站/华东理工/凌云路
上海-徐汇区-复兴中路	肇嘉浜路/枫林路/斜土路/湖南路/万体馆/衡山路
上海-徐汇区-华泾	植物园/长桥/龙华/上海南站/华东理工/漕宝路地铁
上海-徐汇区-斜土路	枫林路/肇嘉浜路/复兴中路/龙华/万体馆/湖南路
上海-徐汇区-漕河泾	漕宝路地铁/上海南站/上师大/田林/华东理工/万体馆
上海-徐汇区-万体馆	衡山路/徐家汇/龙华/漕宝路地铁/肇嘉浜路/交大
上海-普陀区-曹杨新村	金沙江路/华师大/长风新村/真如/武宁路/长征
上海-普陀区-中远两湾城	宜川路/长寿路/光新/甘泉路/石泉路/武宁路
上海-普陀区-华师大	金沙江路/曹杨新村/长风新村/武宁路/真如/石泉路
上海-普陀区-光新	甘泉路/长寿路/宜川路/石泉路/中远两湾城/武宁路
上海-普陀区-金沙江路	华师大/曹杨新村/长风新村/真如/武宁路/长征
上海-普陀区-长寿路	中远两湾城/光新/宜川路/甘泉路/石泉路/武宁路
上海-普陀区-真如	曹杨新村/长风新村/金沙江路/万里城/长征/华师大
上海-普陀区-武宁路	石泉路/华师大/曹杨新村/金沙江路/光新/甘泉路
上海-普陀区-万里城	真如/曹杨新村/武宁路/金沙江路/长风新村/石泉路
上海-普陀区-石泉路	武宁路/光新/甘泉路/长寿路/宜川路/华师大
上海-普陀区-宜川路	中远两湾城/甘泉路/光新/长寿路/石泉路/武宁路
上海-普陀区-长风新村	曹杨新村/金沙江路/华师大/真如/长征/真光新村
上海-普陀区-长征	真光新村/长风新村/真如/曹杨新村/金沙江路/华师大
上海-普陀区-甘泉路	光新/宜川路/石泉路/中远两湾城/长寿路/武宁路
上海-普陀区-桃浦	真光新村/长征/真如/万里城/长风新村/曹杨新村
上海-普陀区-真光新村	长征/真如/长风新村/万里城/曹杨新村/金沙江路
上海-松江区-莘闵	九亭/新桥/泗泾/洞泾/松江工业区/中山
上海-松江区-松江大学城	方松/松江新城/永丰/松江老城/岳阳/中山
上海-松江区-松江科技园	佘山/永丰/方松/松江大学城/松江老城/松江新城
上海-松江区-方松	永丰/松江大学城/松江新城/松江老城/岳阳/中山
上海-松江区-松江工业区	中山/岳阳/松江新城/松江老城/洞泾/松江大学城
上海-松江区-泗泾	洞泾/九亭/中山/新桥/松江工业区/松江大学城
上海-松江区-九亭	莘闵/新桥/泗泾/洞泾/松江工业区/中山
上海-松江区-永丰	方松/松江老城/松江新城/岳阳/松江大学城/中山
上海-松江区-新桥	莘闵/九亭/洞泾/泗泾/松江工业区/中山
上海-松江区-松江老城	岳阳/松江新城/永丰/方松/中山/松江工业区
上海-松江区-松江新城	岳阳/松江老城/方松/松江大学城/中山/永丰
上海-松江区-洞泾	泗泾/中山/松江工业区/松江新城/新桥/岳阳
上海-松江区-中山	松江工业区/岳阳/松江新城/松江老城/松江大学城/方松
上海-松江区-佘山	松江大学城/方松/松江科技园/永丰/松江新城/松江老城
上海-松江区-岳阳	松江老城/松江新城/中山/松江工业区/永丰/方松
武汉-~口-汉正	武胜路/六角亭/宝丰/汉中/崇仁/荣华
武汉-~口-荣华	崇仁/汉中/宝丰/汉水桥/武胜路/汉正
武汉-~口-六角亭	汉正/武胜路/宝丰/汉中/崇仁/荣华
武汉-~口-汉中	崇仁/宝丰/武胜路/荣华/汉正/六角亭
武汉-~口-易家墩	古田/韩家墩/宗关/汉水桥/荣华/崇仁
武汉-~口-宗关	韩家墩/汉水桥/荣华/崇仁/汉中/易家墩
武汉-~口-汉水桥	荣华/宗关/崇仁/汉中/宝丰/武胜路
武汉-~口-韩家墩	宗关/易家墩/古田/汉水桥/荣华/崇仁
武汉-~口-崇仁	汉中/宝丰/荣华/武胜路/汉正/汉水桥
武汉-~口-古田	易家墩/韩家墩/宗关/汉水桥/荣华/崇仁
武汉-~口-武胜路	宝丰/汉正/汉中/崇仁/六角亭/荣华
武汉-~口-宝丰	崇仁/汉中/武胜路/荣华/汉正/六角亭
武汉-江汉-西北湖	常青/红旗渠/万松/杨汊湖/汉兴/新华
武汉-江汉-万松	新华/民意/唐家墩/满春/常青/杨汊湖
武汉-江汉-民意	满春/前进/水塔/万松/新华/民权
武汉-江汉-新华	唐家墩/万松/民意/杨汊湖/满春/汉兴
武汉-江汉-前进	水塔/满春/民权/民意/民族/新华
武汉-江汉-汉兴	杨汊湖/红旗渠/常青/唐家墩/新华/万松
武汉-江汉-民权	民族/水塔/前进/满春/民意/新华
武汉-江汉-北湖	民族/民权/水塔/前进/满春/民意
武汉-江汉-红旗渠	杨汊湖/汉兴/常青/唐家墩/新华/万松
武汉-江汉-唐家墩	新华/万松/杨汊湖/汉兴/民意/红旗渠
武汉-江汉-杨汊湖	汉兴/红旗渠/常青/唐家墩/新华/万松
武汉-江汉-民族	民权/水塔/前进/满春/民意/新华
武汉-江汉-水塔	前进/民权/民族/满春/民意/新华
武汉-江汉-满春	民意/前进/水塔/民权/民族/万松
武汉-江汉-常青	红旗渠/杨汊湖/汉兴/万松/新华/唐家墩
武汉-汉南-邓南	纱帽
武汉-汉南-纱帽	邓南
武汉-江岸-新村	百步亭/二七/岱山/丹水池/后湖/四唯
武汉-江岸-台北路	建设大道/江汉路/花桥/西马/香港路/球场街
武汉-江岸-四唯	永清/三阳路/一元路/劳动/车站/上海
武汉-江岸-建设大道	台北路/江汉路/花桥/西马/香港路/球场街
武汉-江岸-劳动	车站/球场街/三阳路/大智街/永清/香港路
武汉-江岸-谌家矶	后湖/丹水池/岱山/百步亭/新村/二七
武汉-江岸-一元路	三阳路/四唯/车站/永清/劳动/上海
武汉-江岸-江汉路	西马/大智街/球场街/香港路/台北路/上海
武汉-江岸-永清	四唯/三阳路/一元路/劳动/车站/球场街
武汉-江岸-二七	新村/永清/四唯/三阳路/百步亭/一元路
武汉-江岸-三阳路	一元路/四唯/永清/车站/劳动/上海
武汉-江岸-球场街	香港路/西马/大智街/劳动/车站/上海
武汉-江岸-丹水池	岱山/后湖/百步亭/新村/二七/谌家矶
武汉-江岸-车站	上海/大智街/劳动/一元路/三阳路/球场街
武汉-江岸-西马	球场街/大智街/香港路/江汉路/上海/车站
武汉-江岸-花桥	香港路/球场街/西马/台北路/江汉路/劳动
武汉-江岸-岱山	后湖/丹水池/百步亭/新村/二七/谌家矶
武汉-江岸-大智街	上海/球场街/车站/西马/劳动/香港路
武汉-江岸-上海	大智街/车站/球场街/西马/劳动/一元路
武汉-江岸-后湖	岱山/丹水池/百步亭/新村/二七/谌家矶
武汉-江岸-香港路	球场街/西马/大智街/劳动/花桥/车站
武汉-江岸-百步亭	岱山/丹水池/后湖/新村/二七/四唯
武汉-洪山-张家湾	关山/光谷/鲁巷/卓刀泉/陈家湾/花山
武汉-洪山-卓刀泉	陈家湾/珞南/广埠屯/街道口/左岭/鲁巷
武汉-洪山-左岭	珞狮南路/街道口/广埠屯/珞南/陈家湾/卓刀泉
武汉-洪山-广埠屯	珞南/陈家湾/卓刀泉/街道口/左岭/珞狮南路
武汉-洪山-关山	光谷/鲁巷/张家湾/卓刀泉/陈家湾/珞南
武汉-洪山-光谷	鲁巷/关山/卓刀泉/陈家湾/珞南/广埠屯
武汉-洪山-珞南	广埠屯/陈家湾/卓刀泉/街道口/左岭/珞狮南路
武汉-洪山-红旗	珞狮南路/左岭/街道口/广埠屯/珞南/陈家湾
武汉-洪山-葛化	花山/张家湾/关山/光谷/鲁巷/卓刀泉
武汉-洪山-陈家湾	卓刀泉/珞南/广埠屯/街道口/左岭/鲁巷
武汉-洪山-街道口	广埠屯/珞南/左岭/陈家湾/卓刀泉/珞狮南路
武汉-洪山-鲁巷	光谷/关山/卓刀泉/陈家湾/珞南/广埠屯
武汉-洪山-珞狮南路	左岭/街道口/广埠屯/珞南/陈家湾/红旗
武汉-洪山-花山	张家湾/葛化/关山/光谷/鲁巷/卓刀泉
武汉-黄陂-六指店	前川/滠口/罗汉寺/横店/盘龙城/祁家湾
武汉-黄陂-横店	盘龙城/滠口/罗汉寺/祁家湾/前川/天河
武汉-黄陂-罗汉寺	横店/前川/祁家湾/滠口/天河/盘龙城
武汉-黄陂-天河	祁家湾/盘龙城/横店/罗汉寺/滠口/前川
武汉-黄陂-滠口	横店/前川/盘龙城/罗汉寺/祁家湾/天河
武汉-黄陂-祁家湾	天河/横店/罗汉寺/盘龙城/滠口/前川
武汉-黄陂-前川	滠口/罗汉寺/横店/六指店/盘龙城/祁家湾
武汉-黄陂-盘龙城	横店/天河/祁家湾/滠口/罗汉寺/前川
武汉-武昌-粮道	粮道街/积玉桥/小东门/首义路/武昌火车站/新河
武汉-武昌-徐东	杨园/中北路/徐家棚/水果湖/东亭/丁字桥
武汉-武昌-武昌火车站	南湖花园/首义路/南湖/粮道/小东门/粮道街
武汉-武昌-南湖花园	南湖/武昌火车站/首义路/武泰闸/小东门/粮道
武汉-武昌-中华路	司门口/黄鹤楼/白沙洲/粮道街/首义路/武泰闸
武汉-武昌-石洞	白沙洲/南湖/武泰闸/南湖花园/首义路/武昌火车站
武汉-武昌-丁字桥	中南路/傅家坡/水果湖/中北路/小东门/珞珈山
武汉-武昌-白沙洲	武泰闸/黄鹤楼/司门口/首义路/中华路/粮道街
武汉-武昌-积玉桥	小东门/粮道/粮道街/新河/武昌火车站/首义路
武汉-武昌-黄鹤楼	中华路/司门口/白沙洲/武泰闸/首义路/粮道街
武汉-武昌-傅家坡	中南路/丁字桥/小东门/武昌火车站/积玉桥/南湖花园
武汉-武昌-中北路	水果湖/徐东/东亭/珞珈山/丁字桥/中南路
武汉-武昌-珞珈山	水果湖/中北路/丁字桥/中南路/东亭/傅家坡
武汉-武昌-小东门	积玉桥/粮道/粮道街/武昌火车站/傅家坡/新河
武汉-武昌-新河	积玉桥/粮道/粮道街/小东门/司门口/首义路
武汉-武昌-徐家棚	杨园/徐东/中北路/水果湖/丁字桥/中南路
武汉-武昌-首义路	武泰闸/武昌火车站/粮道街/粮道/南湖花园/白沙洲
武汉-武昌-粮道街	粮道/积玉桥/首义路/新河/小东门/武昌火车站
武汉-武昌-紫阳	中华路/黄鹤楼/司门口/白沙洲/粮道街/武泰闸
武汉-武昌-东亭	中北路/徐东/水果湖/珞珈山/杨园/丁字桥
武汉-武昌-南湖	南湖花园/武昌火车站/武泰闸/首义路/粮道/小东门
武汉-武昌-武泰闸	首义路/白沙洲/武昌火车站/南湖/南湖花园/黄鹤楼
武汉-武昌-中南路	丁字桥/傅家坡/水果湖/小东门/中北路/珞珈山
武汉-武昌-水果湖	中北路/丁字桥/珞珈山/中南路/徐东/东亭
武汉-武昌-司门口	中华路/黄鹤楼/粮道街/白沙洲/首义路/粮道
武汉-武昌-杨园	徐东/徐家棚/中北路/东亭/水果湖/丁字桥
武汉-江夏-金口	郑店/纸坊/乌龙泉/流芳
武汉-江夏-流芳	乌龙泉/纸坊/郑店/金口
武汉-江夏-郑店	纸坊/乌龙泉/金口/流芳
武汉-江夏-乌龙泉	纸坊/郑店/流芳/金口
武汉-江夏-纸坊	乌龙泉/郑店/流芳/金口
武汉-汉阳-琴断口	七里庙/江汉二桥/五里墩/郭茨口/月湖/洲头
武汉-汉阳-晴川	建桥/翠微/鹦鹉/钟家村/洲头/月湖
武汉-汉阳-七里庙	五里墩/琴断口/月湖/江汉二桥/郭茨口/洲头
武汉-汉阳-建桥	翠微/鹦鹉/钟家村/晴川/洲头/月湖
武汉-汉阳-鹦鹉	翠微/建桥/钟家村/洲头/月湖/晴川
武汉-汉阳-钟家村	翠微/鹦鹉/月湖/建桥/洲头/五里墩
武汉-汉阳-翠微	鹦鹉/钟家村/建桥/洲头/月湖/晴川
武汉-汉阳-洲头	钟家村/鹦鹉/翠微/月湖/五里墩/建桥
武汉-汉阳-郭茨口	江汉二桥/琴断口/七里庙/五里墩/月湖/洲头
武汉-汉阳-王家湾	晴川/建桥/鹦鹉/翠微/钟家村/洲头
武汉-汉阳-五里墩	七里庙/月湖/琴断口/洲头/钟家村/翠微
武汉-汉阳-月湖	钟家村/五里墩/洲头/翠微/七里庙/鹦鹉
武汉-汉阳-江汉二桥	郭茨口/琴断口/七里庙/五里墩/月湖/洲头
武汉-新洲-三店	邾城/汪集/李集/潘塘/旧街/仓埠
武汉-新洲-双柳	阳逻/汪集/仓埠/李集/邾城/三店
武汉-新洲-汪集	李集/三店/邾城/双柳/仓埠/阳逻
武汉-新洲-潘塘	旧街/邾城/三店/汪集/李集/仓埠
武汉-新洲-仓埠	李集/阳逻/汪集/双柳/三店/邾城
武汉-新洲-李集	汪集/仓埠/三店/邾城/双柳/阳逻
武汉-新洲-邾城	三店/汪集/潘塘/旧街/李集/双柳
武汉-新洲-阳逻	双柳/仓埠/李集/汪集/三店/邾城
武汉-新洲-旧街	潘塘/邾城/三店/汪集/李集/双柳
武汉-青山-厂前	工人村/武东/红钢城/新沟桥/建设七路/青山
武汉-青山-红钢城	新沟桥/建设七路/青山/钢都/冶金/钢花村
武汉-青山-钢都	青山/冶金/建设七路/新沟桥/钢花村/红钢城
武汉-青山-工人村	厂前/红钢城/新沟桥/建设七路/青山/钢都
武汉-青山-建设七路	青山/新沟桥/钢都/红钢城/冶金/钢花村
武汉-青山-新沟桥	青山/红钢城/建设七路/钢都/冶金/钢花村
武汉-青山-和平大道	友谊大道/建设二路/钢花村/冶金/钢都/青山
武汉-青山-青山	钢都/建设七路/新沟桥/冶金/红钢城/钢花村
武汉-青山-友谊大道	和平大道/建设二路/钢花村/冶金/钢都/青山
武汉-青山-武东	厂前/白玉山/工人村/红钢城/新沟桥/建设七路
武汉-青山-建设二路	冶金/钢花村/钢都/青山/建设七路/新沟桥
武汉-青山-冶金	钢都/钢花村/青山/新沟桥/建设七路/红钢城
武汉-青山-白玉山	武东/厂前/工人村/红钢城/新沟桥/建设七路
武汉-青山-钢花村	冶金/钢都/青山/新沟桥/建设七路/红钢城
武汉-蔡甸-侏儒	永安/张湾/L山/蔡甸/大集
武汉-蔡甸-L山	大集/蔡甸/永安/张湾/侏儒
武汉-蔡甸-永安	L山/张湾/侏儒/蔡甸/大集
武汉-蔡甸-张湾	蔡甸/永安/L山/大集/侏儒
武汉-蔡甸-大集	蔡甸/L山/张湾/永安/侏儒
武汉-蔡甸-蔡甸	大集/L山/张湾/永安/侏儒
武汉-东西湖-三店	吴家山/慈惠墩/径河/柏泉/金银湖/李家墩
武汉-东西湖-李家墩	常青花园/将军路/金银湖/径河/长青/三店
武汉-东西湖-吴家山	三店/慈惠墩/径河/柏泉/金银湖/李家墩
武汉-东西湖-走马岭	荷包湖/东山/新沟/柏泉/辛安渡/慈惠墩
武汉-东西湖-辛安渡	新沟/荷包湖/东山/走马岭/柏泉/慈惠墩
武汉-东西湖-径河	三店/金银湖/吴家山/柏泉/慈惠墩/李家墩
武汉-东西湖-东山	荷包湖/走马岭/新沟/辛安渡/柏泉/慈惠墩
武汉-东西湖-荷包湖	新沟/走马岭/辛安渡/东山/柏泉/慈惠墩
武汉-东西湖-长青	将军路/常青花园/李家墩/金银湖/径河/三店
武汉-东西湖-慈惠墩	吴家山/三店/径河/柏泉/金银湖/走马岭
武汉-东西湖-常青花园	将军路/李家墩/金银湖/长青/径河/三店
武汉-东西湖-金银湖	径河/李家墩/常青花园/三店/吴家山/将军路
武汉-东西湖-新沟	辛安渡/荷包湖/东山/走马岭/柏泉/慈惠墩
武汉-东西湖-将军路	常青花园/李家墩/长青/金银湖/径河/三店
武汉-东西湖-柏泉	三店/吴家山/径河/慈惠墩/金银湖/走马岭
杭州-滨江-长河	西兴/浦沿
杭州-滨江-西兴	长河/浦沿
杭州-滨江-浦沿	长河/西兴
杭州-富阳-富春	东洲/春江/鹿山
杭州-富阳-春江	鹿山/东洲/富春
杭州-富阳-东洲	春江/鹿山/富春
杭州-富阳-鹿山	春江/东洲/富春
杭州-余杭-临平	东湖/南苑/星桥/良渚/闲林/老余杭
杭州-余杭-南苑	东湖/临平/星桥/良渚/闲林/老余杭
杭州-余杭-老余杭	闲林/良渚/星桥/临平/东湖/南苑
杭州-余杭-星桥	良渚/闲林/老余杭/临平/东湖/南苑
杭州-余杭-闲林	老余杭/良渚/星桥/临平/东湖/南苑
杭州-余杭-良渚	星桥/闲林/老余杭/临平/东湖/南苑
杭州-余杭-东湖	南苑/临平/星桥/良渚/闲林/老余杭
杭州-临安-玲珑	锦城/青山湖/上甘
杭州-临安-上甘	玲珑/锦城/青山湖
杭州-临安-锦城	青山湖/玲珑/上甘
杭州-临安-青山湖	锦城/玲珑/上甘
杭州-上城-平海路	湖滨/清波/小营/吴山/紫阳/望江
杭州-上城-南星	紫阳/望江/吴山/清波/小营/湖滨
杭州-上城-吴山	紫阳/清波/望江/小营/平海路/湖滨
杭州-上城-望江	吴山/小营/紫阳/清波/平海路/南星
杭州-上城-小营	望江/吴山/平海路/清波/紫阳/湖滨
杭州-上城-紫阳	吴山/清波/望江/湖滨/小营/平海路
杭州-上城-湖滨	平海路/清波/吴山/紫阳/小营/望江
杭州-上城-清波	吴山/紫阳/湖滨/平海路/小营/望江
杭州-江干-钱江新城	四季青/三堡/景芳/采荷/凯旋/彭埠
杭州-江干-彭埠	三堡/笕桥/五堡/四季青/景芳/钱江新城
杭州-江干-景芳	四季青/三堡/钱江新城/凯旋/采荷/闸弄口
杭州-江干-九堡	五堡/丁桥/彭埠/下沙/笕桥/三堡
杭州-江干-白杨	下沙/九堡/五堡/彭埠/丁桥/笕桥
杭州-江干-丁桥	笕桥/彭埠/五堡/三堡/三里亭/景芳
杭州-江干-闸弄口	三里亭/凯旋/采荷/景芳/四季青/钱江新城
杭州-江干-四季青	景芳/三堡/钱江新城/采荷/凯旋/彭埠
杭州-江干-三里亭	闸弄口/凯旋/景芳/采荷/四季青/笕桥
杭州-江干-五堡	彭埠/三堡/笕桥/四季青/景芳/钱江新城
杭州-江干-采荷	凯旋/闸弄口/景芳/四季青/钱江新城/三里亭
杭州-江干-凯旋	采荷/闸弄口/景芳/四季青/三里亭/钱江新城
杭州-江干-三堡	四季青/景芳/钱江新城/彭埠/五堡/采荷
杭州-江干-下沙	白杨/九堡/五堡/彭埠/丁桥/笕桥
杭州-江干-笕桥	彭埠/丁桥/景芳/三堡/四季青/五堡
杭州-桐庐-瑶琳	横村/旧县/分水/富春江/桐君/百江
杭州-桐庐-桐君	富春江/旧县/横村/凤川/江南/瑶琳
杭州-桐庐-横村	旧县/富春江/桐君/瑶琳/江南/凤川
杭州-桐庐-凤川	江南/桐君/富春江/旧县/横村/瑶琳
杭州-桐庐-富春江	旧县/桐君/横村/瑶琳/凤川/江南
杭州-桐庐-百江	分水/瑶琳/横村/旧县/富春江/桐君
杭州-桐庐-分水	百江/瑶琳/横村/旧县/富春江/桐君
杭州-桐庐-旧县	横村/富春江/桐君/瑶琳/江南/凤川
杭州-桐庐-江南	凤川/桐君/富春江/旧县/横村/瑶琳
杭州-淳安-威坪	梓桐/唐村/大墅/姜家/枫树岭/千岛湖
杭州-淳安-临岐	文昌/千岛湖/石林/唐村/威坪/梓桐
杭州-淳安-石林	千岛湖/文昌/临岐/唐村/威坪/梓桐
杭州-淳安-文昌	临岐/千岛湖/石林/唐村/威坪/梓桐
杭州-淳安-大墅	枫树岭/姜家/梓桐/威坪/汾口/唐村
杭州-淳安-唐村	威坪/梓桐/千岛湖/大墅/姜家/枫树岭
杭州-淳安-梓桐	威坪/大墅/姜家/枫树岭/唐村/汾口
杭州-淳安-千岛湖	石林/临岐/文昌/唐村/威坪/梓桐
杭州-淳安-姜家	枫树岭/大墅/汾口/梓桐/中洲/威坪
杭州-淳安-汾口	中洲/姜家/枫树岭/大墅/梓桐/威坪
杭州-淳安-枫树岭	大墅/姜家/梓桐/汾口/威坪/中洲
杭州-淳安-中洲	汾口/姜家/枫树岭/大墅/梓桐/威坪
杭州-拱墅-大关	香积寺路/德胜/湖墅/米市巷/石祥路/余杭塘上
杭州-拱墅-和睦	小河/莫干山路/拱宸桥/余杭塘上/湖墅/石祥路
杭州-拱墅-米市巷	香积寺路/密渡桥路/湖墅/余杭塘上/大关/德胜
杭州-拱墅-拱宸桥	湖墅/余杭塘上/小河/和睦/石祥路/大关
杭州-拱墅-湖墅	余杭塘上/拱宸桥/米市巷/大关/香积寺路/石祥路
杭州-拱墅-小河	和睦/拱宸桥/莫干山路/余杭塘上/湖墅/石祥路
杭州-拱墅-石祥路	大关/拱宸桥/湖墅/香积寺路/余杭塘上/小河
杭州-拱墅-半山	德胜/大关/香积寺路/石祥路/密渡桥路/米市巷
杭州-拱墅-德胜	香积寺路/大关/密渡桥路/米市巷/湖墅/余杭塘上
杭州-拱墅-莫干山路	和睦/小河/拱宸桥/余杭塘上/湖墅/石祥路
杭州-拱墅-香积寺路	大关/德胜/米市巷/湖墅/密渡桥路/余杭塘上
杭州-拱墅-余杭塘上	湖墅/拱宸桥/米市巷/香积寺路/大关/小河
杭州-拱墅-密渡桥路	米市巷/德胜/香积寺路/大关/湖墅/余杭塘上
杭州-下城-潮鸣	长庆/艮山/朝晖/武林/天水/三塘
杭州-下城-三塘	天水/武林/朝晖/长庆/艮山/潮鸣
杭州-下城-朝晖	武林/天水/艮山/长庆/潮鸣/三塘
杭州-下城-天水	武林/朝晖/长庆/艮山/潮鸣/三塘
杭州-下城-艮山	潮鸣/长庆/朝晖/武林/天水/三塘
杭州-下城-长庆	潮鸣/艮山/武林/朝晖/天水/三塘
杭州-下城-武林	天水/朝晖/长庆/艮山/潮鸣/三塘
杭州-西湖-文一路	文二路/文三路/翠苑/灵隐/北山/古荡
杭州-西湖-文二路	文一路/文三路/灵隐/翠苑/北山/古荡
杭州-西湖-西溪	蒋村/文新/古荡/申花/翠苑/三墩
杭州-西湖-翠苑	古荡/文一路/文二路/申花/文新/文三路
杭州-西湖-文三路	文二路/文一路/灵隐/北山/翠苑/古荡
杭州-西湖-转塘	留下/西溪/蒋村/文新/古荡/灵隐
杭州-西湖-古荡	翠苑/文新/灵隐/申花/文一路/文二路
杭州-西湖-文新	古荡/申花/西溪/蒋村/翠苑/灵隐
杭州-西湖-北山	文三路/文二路/文一路/西湖/灵隐/翠苑
杭州-西湖-蒋村	西溪/文新/三墩/申花/古荡/翠苑
杭州-西湖-留下	蒋村/西溪/三墩/转塘/文新/古荡
杭州-西湖-申花	文新/翠苑/古荡/蒋村/西溪/三墩
杭州-西湖-三墩	蒋村/申花/文新/西溪/古荡/翠苑
杭州-西湖-西湖	北山/文三路/文二路/灵隐/文一路/翠苑
杭州-西湖-灵隐	文三路/文二路/文一路/古荡/翠苑/北山
杭州-建德-更楼	新安江/洋溪
杭州-建德-新安江	更楼/洋溪
杭州-建德-洋溪	新安江/更楼
杭州-萧山-城厢	北干/蜀山/新塘/闻堰
杭州-萧山-闻堰	城厢/新塘/北干/蜀山
杭州-萧山-蜀山	北干/城厢/新塘/闻堰
杭州-萧山-新塘	城厢/北干/闻堰/蜀山
杭州-萧山-北干	蜀山/城厢/新塘/闻堰
天津-宁河县-岳龙	板桥/苗庄/宁河/丰台/芦台/廉庄
天津-宁河县-板桥	苗庄/宁河/廉庄/丰台/岳龙/芦台
天津-宁河县-芦台经济开发区	大北涧沽/廉庄/宁河/苗庄/芦台/板桥
天津-宁河县-丰台	宁河/板桥/廉庄/芦台经济开发区/苗庄/大北涧沽
天津-宁河县-芦台	苗庄/廉庄/板桥/芦台经济开发区/宁河/大北涧沽
天津-宁河县-清河农场	七里海/大北涧沽/北淮淀/芦台经济开发区/l口/廉庄
天津-宁河县-东棘坨	l口/北淮淀/潘庄/七里海/造甲城/清河农场
天津-宁河县-宁河	廉庄/板桥/丰台/芦台经济开发区/苗庄/大北涧沽
天津-宁河县-大北涧沽	芦台经济开发区/廉庄/宁河/七里海/芦台/清河农场
天津-宁河县-造甲城	潘庄/东棘坨/l口/北淮淀/七里海/清河农场
天津-宁河县-七里海	清河农场/大北涧沽/芦台经济开发区/北淮淀/l口/廉庄
天津-宁河县-潘庄	造甲城/东棘坨/l口/北淮淀/七里海/清河农场
天津-宁河县-廉庄	芦台经济开发区/宁河/大北涧沽/苗庄/板桥/芦台
天津-宁河县-苗庄	板桥/芦台/宁河/廉庄/芦台经济开发区/丰台
天津-宁河县-l口	北淮淀/东棘坨/七里海/潘庄/清河农场/造甲城
天津-宁河县-北淮淀	l口/东棘坨/七里海/清河农场/潘庄/造甲城
天津-红桥区-铃铛阁	邵公庄/西于庄/大胡同/芥园道/西沽/丁字沽
天津-红桥区-咸阳北路	丁字沽/邵公庄/西于庄/芥园道/双环村/铃铛阁
天津-红桥区-芥园道	邵公庄/铃铛阁/西于庄/咸阳北路/丁字沽/大胡同
天津-红桥区-邵公庄	芥园道/铃铛阁/西于庄/丁字沽/咸阳北路/大胡同
天津-红桥区-西沽	大胡同/三条石/西于庄/丁字沽/铃铛阁/邵公庄
天津-红桥区-丁字沽	西于庄/邵公庄/咸阳北路/西沽/铃铛阁/大胡同
天津-红桥区-三条石	大胡同/西沽/铃铛阁/西于庄/丁字沽/邵公庄
天津-红桥区-西于庄	丁字沽/铃铛阁/邵公庄/西沽/大胡同/芥园道
天津-红桥区-双环村	咸阳北路/芥园道/邵公庄/丁字沽/西于庄/铃铛阁
天津-红桥区-大胡同	西沽/三条石/铃铛阁/西于庄/邵公庄/丁字沽
天津-南开区-向阳路	密云路/嘉陵道/黄河道/长虹街/天拖南/王顶堤
天津-南开区-荣业大街	鼓楼/兴南街/八里台/万兴街/广开街/学府街
天津-南开区-八里台	学府街/兴南街/万兴街/荣业大街/广开街/鼓楼
天津-南开区-嘉陵道	黄河道/长虹街/向阳路/天拖南/王顶堤/体育中心
天津-南开区-长虹街	黄河道/嘉陵道/体育中心/广开街/向阳路/天拖南
天津-南开区-体育中心	长虹街/万兴街/王顶堤/天拖南/黄河道/学府街
天津-南开区-鼓楼	荣业大街/兴南街/广开街/万兴街/学府街/八里台
天津-南开区-华苑南	王顶堤/天拖南/华苑/嘉陵道/体育中心/向阳路
天津-南开区-广开街	万兴街/学府街/兴南街/鼓楼/体育中心/长虹街
天津-南开区-密云路	向阳路/嘉陵道/黄河道/华苑/长虹街/天拖南
天津-南开区-天拖南	王顶堤/嘉陵道/华苑南/体育中心/黄河道/向阳路
天津-南开区-兴南街	荣业大街/鼓楼/万兴街/学府街/广开街/八里台
天津-南开区-学府街	万兴街/八里台/广开街/兴南街/体育中心/荣业大街
天津-南开区-王顶堤	天拖南/华苑南/嘉陵道/体育中心/黄河道/向阳路
天津-南开区-黄河道	长虹街/嘉陵道/体育中心/向阳路/天拖南/王顶堤
天津-南开区-华苑	华苑南/天拖南/王顶堤/向阳路/密云路/嘉陵道
天津-南开区-万兴街	学府街/广开街/兴南街/体育中心/八里台/鼓楼
天津-河西区-土城	尖山/挂甲寺/下瓦房/桃园街/大营门/梅江
天津-河西区-柳林	东海街/小海地/陈塘庄/土城/尖山/挂甲寺
天津-河西区-天塔	友谊路/马场/越秀路/大营门/桃园街/梅江
天津-河西区-东海街	小海地/柳林/陈塘庄/土城/尖山/挂甲寺
天津-河西区-友谊路	越秀路/马场/桃园街/梅江/大营门/尖山
天津-河西区-小海地	东海街/陈塘庄/柳林/土城/尖山/挂甲寺
天津-河西区-下瓦房	挂甲寺/桃园街/大营门/尖山/土城/越秀路
天津-河西区-马场	大营门/桃园街/越秀路/友谊路/下瓦房/挂甲寺
天津-河西区-桃园街	大营门/下瓦房/挂甲寺/越秀路/马场/尖山
天津-河西区-挂甲寺	下瓦房/尖山/桃园街/土城/大营门/越秀路
天津-河西区-越秀路	友谊路/桃园街/马场/大营门/梅江/尖山
天津-河西区-陈塘庄	小海地/东海街/土城/尖山/挂甲寺/柳林
天津-河西区-尖山	挂甲寺/土城/下瓦房/桃园街/梅江/越秀路
天津-河西区-大营门	桃园街/马场/下瓦房/挂甲寺/越秀路/尖山
天津-河西区-梅江	越秀路/尖山/友谊路/桃园街/挂甲寺/土城
天津-东丽区-么六桥	华明/新立/丰年村/张贵庄/先锋路/利津路
天津-东丽区-华明	么六桥/新立/丰年村/军粮城/张贵庄/先锋路
天津-东丽区-新立	丰年村/张贵庄/先锋路/利津路/么六桥/程林庄
天津-东丽区-丰年村	新立/张贵庄/先锋路/利津路/程林庄/么六桥
天津-东丽区-利津路	先锋路/张贵庄/程林庄/丰年村/新立/大毕庄
天津-东丽区-先锋路	张贵庄/利津路/丰年村/程林庄/新立/大毕庄
天津-东丽区-程林庄	利津路/张贵庄/先锋路/大毕庄/丰年村/新立
天津-东丽区-军粮城	无瑕/么六桥/华明/新立/丰年村/张贵庄
天津-东丽区-张贵庄	先锋路/利津路/丰年村/新立/程林庄/么六桥
天津-东丽区-大毕庄	程林庄/利津路/张贵庄/先锋路/丰年村/新立
天津-东丽区-无瑕	军粮城/津塘路/么六桥/华明/新立/丰年村
天津-东丽区-津塘路	无瑕/军粮城/华明/么六桥/新立/丰年村
天津-西青区-中北	侯台/南河/西营门/张家窝/杨柳青/李七庄
天津-西青区-侯台	中北/西营门/南河/张家窝/李七庄/杨柳青
天津-西青区-王稳庄	大寺/李七庄/西营门/侯台/南河/中北
天津-西青区-南河	侯台/中北/张家窝/西营门/李七庄/杨柳青
天津-西青区-西营门	侯台/中北/南河/李七庄/张家窝/大寺
天津-西青区-张家窝	杨柳青/南河/中北/辛口/侯台/西营门
天津-西青区-大寺	李七庄/王稳庄/西营门/侯台/南河/中北
天津-西青区-辛口	杨柳青/张家窝/中北/南河/侯台/西营门
天津-西青区-李七庄	大寺/西营门/侯台/王稳庄/南河/中北
天津-西青区-杨柳青	辛口/张家窝/中北/南河/侯台/西营门
天津-开发区-第一大街	第二大街/第三大街/鲲鹏街/第五大街/第四大街
天津-开发区-第五大街	第四大街/鲲鹏街/第三大街/第二大街/第一大街
天津-开发区-第三大街	第二大街/第一大街/第五大街/第四大街/鲲鹏街
天津-开发区-鲲鹏街	第四大街/第五大街/第二大街/第一大街/第三大街
天津-开发区-第四大街	鲲鹏街/第五大街/第二大街/第三大街/第一大街
天津-开发区-第二大街	第一大街/第三大街/鲲鹏街/第五大街/第四大街
天津-河北区-光复道	望海楼/鸿顺里/新开河/铁东路/宁园/王串场
天津-河北区-王串场	宁园/建昌道/江都路/靖江路/月牙河/铁东路
天津-河北区-望海楼	鸿顺里/光复道/新开河/铁东路/宁园/王串场
天津-河北区-建昌道	王串场/宁园/江都路/靖江路/月牙河/铁东路
天津-河北区-江都路	靖江路/月牙河/王串场/建昌道/宁园/铁东路
天津-河北区-新开河	鸿顺里/望海楼/铁东路/光复道/宁园/王串场
天津-河北区-鸿顺里	望海楼/新开河/光复道/铁东路/宁园/王串场
天津-河北区-宁园	王串场/建昌道/铁东路/江都路/光复道/望海楼
天津-河北区-靖江路	江都路/月牙河/王串场/建昌道/宁园/铁东路
天津-河北区-铁东路	新开河/宁园/望海楼/鸿顺里/光复道/建昌道
天津-河北区-月牙河	靖江路/江都路/建昌道/王串场/宁园/铁东路
天津-河东区-铁厂	东新街/鲁山道/程林/上杭路/中山门/大桥道
天津-河东区-程林	东新街/铁厂/鲁山道/上杭路/中山门/二号桥
天津-河东区-东新街	程林/铁厂/鲁山道/上杭路/中山门/大桥道
天津-河东区-大桥道	富民路/中山门/大直沽/向阳楼/唐家口/唐口
天津-河东区-大直沽	张贵庄/唐口/唐家口/大桥道/向阳楼/富民路
天津-河东区-唐家口	唐口/张贵庄/向阳楼/常州道/大直沽/大桥道
天津-河东区-大王庄	春华街/张贵庄/大直沽/唐口/唐家口/常州道
天津-河东区-富民路	大桥道/中山门/大直沽/上杭路/唐家口/唐口
天津-河东区-唐口	唐家口/张贵庄/向阳楼/常州道/大直沽/大桥道
天津-河东区-张贵庄	唐口/唐家口/大直沽/向阳楼/常州道/大桥道
天津-河东区-上杭路	中山门/大桥道/东新街/向阳楼/富民路/鲁山道
天津-河东区-常州道	向阳楼/唐家口/唐口/张贵庄/大直沽/大桥道
天津-河东区-春华街	大王庄/张贵庄/唐口/唐家口/大直沽/常州道
天津-河东区-中山门	上杭路/大桥道/富民路/东新街/程林/向阳楼
天津-河东区-二号桥	程林/东新街/铁厂/中山门/鲁山道/上杭路
天津-河东区-鲁山道	铁厂/东新街/程林/上杭路/中山门/向阳楼
天津-河东区-向阳楼	唐家口/常州道/唐口/张贵庄/大桥道/大直沽
天津-塘沽区-杭州道	新村街/新河街/工农村/向阳街/解放路/三槐路
天津-塘沽区-渤海石油	新港/三槐路/塘沽新村街/大沽街/北塘街/解放路
天津-塘沽区-新村街	杭州道/新河街/解放路/向阳街/工农村/大沽街
天津-塘沽区-新城	胡家园/新河街/杭州道/新村街/工农村/解放路
天津-塘沽区-胡家园	新城/新河街/杭州道/新村街/工农村/解放路
天津-塘沽区-北塘街	新港/渤海石油/三槐路/工农村/向阳街/解放路
天津-塘沽区-解放路	向阳街/新村街/工农村/杭州道/三槐路/大沽街
天津-塘沽区-塘沽新村街	大沽街/三槐路/解放路/向阳街/渤海石油/新港
天津-塘沽区-大沽街	塘沽新村街/三槐路/解放路/向阳街/渤海石油/新村街
天津-塘沽区-工农村	向阳街/杭州道/解放路/新村街/新河街/三槐路
天津-塘沽区-向阳街	解放路/工农村/新村街/杭州道/三槐路/大沽街
天津-塘沽区-新河街	杭州道/新村街/工农村/向阳街/解放路/胡家园
天津-塘沽区-三槐路	大沽街/塘沽新村街/解放路/向阳街/渤海石油/新港
天津-塘沽区-新港	渤海石油/三槐路/塘沽新村街/大沽街/北塘街/向阳街
天津-宝坻区-牛家牌	郝各庄/大口屯/马家店/城关/周良庄/尔王庄
天津-宝坻区-霍各庄	口东/方家庄/王卜庄/城关/郝各庄/周良庄
天津-宝坻区-牛道口	高家庄/史各庄/城关/马家店/新开口/郝各庄
天津-宝坻区-大钟庄	新安/林亭口/八门城/黄庄/王卜庄/方家庄
天津-宝坻区-王卜庄	方家庄/霍各庄/林亭口/口东/周良庄/新安
天津-宝坻区-大唐庄	大白庄/尔王庄/黄庄/周良庄/林亭口/王卜庄
天津-宝坻区-林亭口	大钟庄/新安/黄庄/王卜庄/方家庄/八门城
天津-宝坻区-城关	高家庄/马家店/郝各庄/牛道口/口东/霍各庄
天津-宝坻区-新开口	史各庄/大口屯/马家店/牛道口/高家庄/城关
天津-宝坻区-黄庄	林亭口/大唐庄/八门城/大钟庄/王卜庄/新安
天津-宝坻区-八门城	大钟庄/黄庄/林亭口/新安/王卜庄/大唐庄
天津-宝坻区-新安	大钟庄/林亭口/八门城/王卜庄/方家庄/黄庄
天津-宝坻区-大白庄	尔王庄/周良庄/大唐庄/牛家牌/郝各庄/口东
天津-宝坻区-尔王庄	大白庄/大唐庄/周良庄/牛家牌/郝各庄/口东
天津-宝坻区-周良庄	口东/大白庄/郝各庄/尔王庄/王卜庄/霍各庄
天津-宝坻区-方家庄	王卜庄/霍各庄/口东/周良庄/林亭口/郝各庄
天津-宝坻区-马家店	高家庄/城关/郝各庄/大口屯/牛道口/牛家牌
天津-宝坻区-口东	霍各庄/郝各庄/周良庄/方家庄/城关/王卜庄
天津-宝坻区-史各庄	新开口/牛道口/高家庄/马家店/大口屯/城关
天津-宝坻区-大口屯	马家店/新开口/牛家牌/史各庄/高家庄/郝各庄
天津-宝坻区-郝各庄	城关/马家店/口东/牛家牌/高家庄/周良庄
天津-宝坻区-高家庄	城关/牛道口/马家店/郝各庄/史各庄/大口屯
天津-津南区-双桥河	小站/北闸口/咸水沽/葛沽/辛庄/双港
天津-津南区-八里台	双港/辛庄/咸水沽/北闸口/小站/双桥河
天津-津南区-辛庄	双港/八里台/咸水沽/北闸口/双桥河/小站
天津-津南区-小站	北闸口/双桥河/咸水沽/葛沽/辛庄/八里台
天津-津南区-葛沽	双桥河/小站/北闸口/咸水沽/辛庄/双港
天津-津南区-双港	辛庄/八里台/咸水沽/北闸口/双桥河/小站
天津-津南区-北闸口	咸水沽/小站/双桥河/辛庄/八里台/双港
天津-津南区-咸水沽	北闸口/双桥河/辛庄/小站/八里台/双港
天津-武清区-杨村	运河西/徐官屯/下朱庄/黄庄/大碱厂/东蒲洼
天津-武清区-豆张庄	黄花店/泗村店/石各庄/汊沽港/东蒲洼/陈嘴
天津-武清区-徐官屯	杨村/下朱庄/运河西/大碱厂/黄庄/曹子里
天津-武清区-下伍旗	大良/河北屯/大碱厂/南蔡村/大孟庄/河西务
天津-武清区-高村	白古屯/城关/大王古庄/河西务/东马圈/泗村店
天津-武清区-王庆坨	汊沽港/石各庄/黄花店/陈嘴/豆张庄/东马圈
天津-武清区-白古屯	城关/高村/泗村店/河西务/豆张庄/东马圈
天津-武清区-南蔡村	东蒲洼/大孟庄/泗村店/杨村/运河西/大碱厂
天津-武清区-城关	白古屯/东马圈/高村/大王古庄/黄花店/泗村店
天津-武清区-石各庄	黄花店/汊沽港/王庆坨/豆张庄/陈嘴/东马圈
天津-武清区-陈嘴	汊沽港/东蒲洼/豆张庄/运河西/杨村/石各庄
天津-武清区-黄庄	下朱庄/运河西/徐官屯/杨村/曹子里/大碱厂
天津-武清区-大黄堡	上马台/梅厂/崔黄口/曹子里/河北屯/大碱厂
天津-武清区-大孟庄	南蔡村/泗村店/东蒲洼/河西务/豆张庄/下伍旗
天津-武清区-黄花店	石各庄/豆张庄/汊沽港/东马圈/泗村店/城关
天津-武清区-东蒲洼	南蔡村/大孟庄/泗村店/杨村/运河西/陈嘴
天津-武清区-下朱庄	运河西/徐官屯/黄庄/杨村/大碱厂/曹子里
天津-武清区-东马圈	城关/大王古庄/黄花店/白古屯/石各庄/高村
天津-武清区-崔黄口	河北屯/梅厂/曹子里/上马台/大黄堡/大良
天津-武清区-大良	大碱厂/河北屯/下伍旗/徐官屯/曹子里/杨村
天津-武清区-运河西	杨村/下朱庄/徐官屯/黄庄/大碱厂/东蒲洼
天津-武清区-泗村店	大孟庄/豆张庄/东蒲洼/南蔡村/白古屯/河西务
天津-武清区-曹子里	大碱厂/徐官屯/下朱庄/梅厂/大良/黄庄
天津-武清区-河北屯	大良/大碱厂/下伍旗/崔黄口/曹子里/徐官屯
天津-武清区-大碱厂	大良/徐官屯/杨村/曹子里/运河西/下朱庄
天津-武清区-大王古庄	城关/东马圈/高村/白古屯/黄花店/河西务
天津-武清区-汊沽港	石各庄/王庆坨/陈嘴/黄花店/豆张庄/东蒲洼
天津-武清区-上马台	大黄堡/梅厂/崔黄口/曹子里/河北屯/大碱厂
天津-武清区-梅厂	上马台/曹子里/崔黄口/大黄堡/大碱厂/河北屯
天津-武清区-河西务	大孟庄/白古屯/泗村店/高村/南蔡村/城关
天津-汉沽区-寨上	天化/汉沽/河西/盐场/营城/大田
天津-汉沽区-天化	寨上/汉沽/盐场/河西/营城/大田
天津-汉沽区-茶淀	大田/营城/河西/寨上/天化/汉沽
天津-汉沽区-大田	河西/营城/寨上/天化/汉沽/盐场
天津-汉沽区-盐场	汉沽/天化/寨上/河西/营城/大田
天津-汉沽区-汉沽	盐场/天化/寨上/河西/营城/大田
天津-汉沽区-杨家泊	盐场/汉沽/天化/寨上/河西/营城
天津-汉沽区-河西	营城/寨上/天化/汉沽/盐场/大田
天津-汉沽区-营城	河西/寨上/天化/汉沽/大田/盐场
天津-蓟县-出头岭	西龙虎峪/马伸桥/五百户/孙各庄满族/穿芳峪/别山
天津-蓟县-侯家营	尤古庄/东二营/施古/邦均/许家台/白涧
天津-蓟县-施古	东二营/东赵各庄/侯家营/邦均/上仓/下窝头
天津-蓟县-别山	礼明庄/杨津庄/穿芳峪/洇溜/文昌街道/上仓
天津-蓟县-穿芳峪	孙各庄满族/马伸桥/五百户/别山/下营/礼明庄
天津-蓟县-官庄	邦均/东二营/许家台/施古/东赵各庄/尤古庄
天津-蓟县-东赵各庄	洇溜/上仓/城关/下窝头/文昌街道/施古
天津-蓟县-下仓	杨津庄/下窝头/上仓/礼明庄/东赵各庄/洇溜
天津-蓟县-邦均	东二营/许家台/尤古庄/官庄/白涧/侯家营
天津-蓟县-桑梓	白涧/尤古庄/许家台/侯家营/邦均/东二营
天津-蓟县-下营	罗庄子/文昌街道/城关/穿芳峪/洇溜/礼明庄
天津-蓟县-城关	文昌街道/洇溜/东赵各庄/罗庄子/礼明庄/上仓
天津-蓟县-西龙虎峪	出头岭/五百户/马伸桥/孙各庄满族/穿芳峪/别山
天津-蓟县-上仓	下窝头/东赵各庄/洇溜/杨津庄/礼明庄/城关
天津-蓟县-下窝头	上仓/杨津庄/下仓/东赵各庄/洇溜/礼明庄
天津-蓟县-东二营	邦均/尤古庄/许家台/官庄/侯家营/施古
天津-蓟县-洇溜	城关/文昌街道/东赵各庄/上仓/礼明庄/下窝头
天津-蓟县-文昌街道	城关/洇溜/罗庄子/礼明庄/东赵各庄/上仓
天津-蓟县-孙各庄满族	马伸桥/穿芳峪/五百户/出头岭/别山/西龙虎峪
天津-蓟县-马伸桥	孙各庄满族/五百户/穿芳峪/出头岭/别山/西龙虎峪
天津-蓟县-罗庄子	下营/文昌街道/城关/洇溜/礼明庄/东赵各庄
天津-蓟县-白涧	许家台/尤古庄/邦均/桑梓/东二营/侯家营
天津-蓟县-五百户	马伸桥/孙各庄满族/穿芳峪/出头岭/别山/西龙虎峪
天津-蓟县-礼明庄	洇溜/杨津庄/上仓/城关/文昌街道/别山
天津-蓟县-杨津庄	下窝头/上仓/下仓/礼明庄/洇溜/东赵各庄
天津-蓟县-许家台	邦均/东二营/白涧/尤古庄/官庄/侯家营
天津-蓟县-尤古庄	侯家营/东二营/邦均/白涧/许家台/施古
天津-和平区-体育馆	南营门/新兴街/滨江道/劝业场/南市/小白楼
天津-和平区-小白楼	滨江道/劝业场/体育馆/南营门/新兴街/南市
天津-和平区-南营门	新兴街/体育馆/南市/劝业场/滨江道/小白楼
天津-和平区-劝业场	滨江道/体育馆/小白楼/南营门/南市/新兴街
天津-和平区-新兴街	南营门/南市/体育馆/劝业场/滨江道/小白楼
天津-和平区-滨江道	劝业场/体育馆/小白楼/南营门/南市/新兴街
天津-和平区-南市	南营门/新兴街/体育馆/劝业场/滨江道/小白楼
天津-北辰区-小淀	大张庄/宜兴埠/普东/天穆/果园新村/北仓
天津-北辰区-宜兴埠	普东/小淀/大张庄/天穆/果园新村/北仓
天津-北辰区-集贤里	北仓/果园新村/双街/天穆/青光/普东
天津-北辰区-普东	宜兴埠/小淀/大张庄/天穆/果园新村/北仓
天津-北辰区-西堤头	大张庄/小淀/宜兴埠/普东/天穆/果园新村
天津-北辰区-果园新村	北仓/集贤里/天穆/双街/普东/青光
天津-北辰区-北仓	集贤里/果园新村/天穆/双街/青光/普东
天津-北辰区-天穆	果园新村/北仓/集贤里/双街/普东/宜兴埠
天津-北辰区-青光	红光农场/双口/双街/集贤里/北仓/果园新村
天津-北辰区-红光农场	双口/青光/双街/集贤里/北仓/果园新村
天津-北辰区-大张庄	小淀/普东/宜兴埠/天穆/果园新村/北仓
天津-北辰区-双街	集贤里/北仓/果园新村/天穆/青光/双口
天津-北辰区-双口	红光农场/青光/双街/集贤里/北仓/果园新村
天津-静海县-良王庄	独流/大丰堆/静海/杨成庄/双塘/陈官屯
天津-静海县-陈官屯	双塘/唐官屯/静海/梁头/沿庄/独流
天津-静海县-梁头	沿庄/台头/静海/独流/双塘/陈官屯
天津-静海县-大丰堆	杨成庄/西翟庄/大邱庄/良王庄/静海/双塘
天津-静海县-独流	静海/良王庄/梁头/双塘/陈官屯/台头
天津-静海县-静海	双塘/独流/陈官屯/梁头/良王庄/大丰堆
天津-静海县-台头	王口/梁头/子牙/沿庄/独流/静海
天津-静海县-沿庄	子牙/梁头/陈官屯/双塘/王口/唐官屯
天津-静海县-西翟庄	大丰堆/大邱庄/蔡公庄/杨成庄/陈官屯/唐官屯
天津-静海县-大邱庄	蔡公庄/杨成庄/西翟庄/大丰堆/团泊/中旺
天津-静海县-团泊	蔡公庄/大邱庄/杨成庄/中旺/大丰堆/西翟庄
天津-静海县-中旺	蔡公庄/大邱庄/团泊/西翟庄/杨成庄/大丰堆
天津-静海县-唐官屯	陈官屯/双塘/沿庄/静海/西翟庄/梁头
天津-静海县-双塘	陈官屯/静海/梁头/独流/唐官屯/沿庄
天津-静海县-杨成庄	大丰堆/大邱庄/蔡公庄/良王庄/西翟庄/团泊
天津-静海县-子牙	王口/沿庄/台头/梁头/陈官屯/双塘
天津-静海县-蔡公庄	大邱庄/西翟庄/杨成庄/中旺/团泊/大丰堆
天津-静海县-王口	子牙/台头/沿庄/梁头/独流/双塘
天津-大港区-小王庄	太平/港西/中塘/胜利街/迎宾街/古林街
天津-大港区-中塘	胜利街/迎宾街/港西/古林街/太平/小王庄
天津-大港区-太平	港西/中塘/胜利街/迎宾街/古林街/小王庄
天津-大港区-海滨	古林街/迎宾街/胜利街/中塘/港西/太平
天津-大港区-港西	太平/中塘/胜利街/迎宾街/古林街/小王庄
天津-大港区-古林街	迎宾街/胜利街/中塘/港西/海滨/太平
天津-大港区-胜利街	迎宾街/古林街/中塘/港西/太平/海滨
天津-大港区-迎宾街	胜利街/古林街/中塘/港西/太平/海滨
