101团	101tuan
102团	102tuan
103团	103tuan
丁青	dingqing
七星	qixing
七里河	qilihe
万全	wanquan
万安	wanan
万山	wanshan
万州	wanzhou
万年	wannian
万柏林	wanbailin
万江	wanjiang
万源	wanyuan
万盛	wansheng
万秀	wanxiu
万荣	wanrong
万载	wanzai
三乡	sanxiang
三亚湾	sanyawan
三伏潭	sanfutan
三元	sanyuan
三原	sanyuan
三台	santai
三山	sanshan
三水	sanshui
三江	sanjiang
三河	sanhe
三穗	sansui
三角	sanjiao
三都	sandou
三门	sanmen
上城	shangcheng
上思	shangsi
上杭	shanghang
上林	shanglin
上栗	shangli
上海周边	shanghaizhoubian
上犹	shangyou
上甘岭	shangganling
上蔡	shangcai
上虞	shangyu
上街	shangjie
上饶县	shangrao
上高	shanggao
下关	xiaguan
下冶	xiaye
下城	xiacheng
下花园区	xiahuayuan
下谷平	xiaguoping
下陆	xialu
且末	qiemo
丘北	qiubei
丛台区	congtai
东丰	dongfeng
东丽	dongli
东乌珠穆沁	dongwuzhumuqin
东乡	dongxiang
东光	dongguang
东兰	donglan
东兴	dongxing
东凤	dongfeng
东区	dongqu
东升	dongsheng
东台	dongtai
东坑	dongkeng
东坡	dongpo
东城	dongcheng
东宁	dongning
东安	dongan
东宝	dongbao
东山	dongshan
东山开发区	dongshankaifaqu
东川	dongchuan
东平	dongping
东昌区	dongchangqu
东昌府	dongchangfu
东明	dongming
东河	donghe
东洲	dongzhou
东海	donghai
东港	donggang
东湖	donghu
东源	dongyuan
东胜	dongsheng
东至	dongzhi
东营区	dongying
东西湖	dongxihu
东辽	dongliao
东阳	dongyang
东阿	donga
东陵	dongling
东风	dongfeng
两当	liangdang
两江新区	liangjiangxinqu
个旧	gejiu
中原	zhongyuan
中堂	zhongtang
中宁	zhongning
中山	zhongshan
中方	zhongfang
中江	zhongjiang
中牟	zhongmou
中站	zhongzhan
中西区	zhongxi
中阳	zhongyang
丰南区	fengnan
丰县	fengxian
丰台	fengtai
丰城	fengcheng
丰宁	fengning
丰泽	fengze
丰润区	fengrun
丰满区	fengmanqu
丰都	fengdu
丰镇	fengzhenshi
丰顺	fengshun
临县	linxian
临城	lincheng
临夏市	linxia
临安	linan
临川	linchuan
临朐	linqu
临桂	lingui
临武	linwu
临江市	linjiangshi
临沭	linshu
临河	linhe
临泉	linquan
临泽	linze
临洮	lintao
临海	linhai
临淄	linzi
临清	linqing
临渭	linwei
临港	lingangqu
临湘	linxiang
临漳	linzhang
临潭	lintan
临潼	lintong
临澧	linli
临猗	linyi
临翔	linxiang
临西	linxi
临邑	linyi
临颍	linying
丹凤	danfeng
丹寨	danzhai
丹巴	danba
丹徒	dantu
丹棱	danleng
丹江口	danjiangkou
丹阳	danyang
乃东	naidong
久治	jiuzhi
义乌	yiwu
义县	yixian
义马	yima
乌什	wushen
乌伊岭	wuyiling
乌兰	wulan
乌兰浩特	wulanhaote
乌审	wushen
乌尔禾	wuerhe
乌当	wudang
乌恰	wuqia
乌拉特中	wulatezhong
乌拉特前	wulateqian
乌拉特后	wulatehou
乌苏	wusu
乌达	wuda
乌马河	wumahe
乌鲁木齐县	wulumuqi
乐业	leye
乐亭	leting
乐安	lean
乐平	leping
乐昌	lechang
乐清	leqing
乐至	lezhi
乐都	ledu
乐陵	leling
九原	jiuyuan
九台	jiutai
九寨沟	jiuzhaigou
九江县	jiujiang
九湖	jiuhu
九真	jiuzhen
九里	jiuli
九龙	jiulong
九龙坡	jiulongpo
九龙城区	jiulong
习水	xishui
乡城	xiangcheng
乡宁	xiangning
乳山	rushan
乳源	ruyuan
乾县	qianxian
乾安	qianan
二七	erqi
二连浩特	erlianhaote
二道	erdao
二道江区	erdaojiangqu
于洪	yuhong
于田	yutian
于都	yudou
云县	yunxian
云和	yunhe
云城	yuncheng
云安	yunan
云岩	yunyan
云梦	yunmeng
云溪	yunxi
云阳	yunyang
云霄	yunxiao
云龙	yunlong
互助	huzhu
五华	wuhua
五原	wuyuan
五台	wutai
五大连池	wudalianchi
五家渠周边	wujiaquzhoubian
五寨	wuzhai
五峰	wufeng
五常	wuchang
五指山周边	wuzhishanzhoubian
五桂山	wuguishan
五河	wuhe
五莲	wulian
五营	wuying
五通桥	wutongqiao
五龙口	wulongkou
井冈山	jinggangshan
井研	jingyan
井陉	jingxing
井陉矿区	jingxingkuangqu
亚东	yadong
亚龙湾	yalongwan
交口	jiaokou
交城	jiaocheng
京口	jingkou
京山	jingshan
亭湖	tinghu
人民路街道	renminlujiedao
什邡	shenfang
仁化	renhua
仁和	renhe
仁寿	renshou
仁布	renbu
仁怀	renhuai
介休	jiexiu
从化	conghua
从江	congjiang
仓山	cangshan
仙居	xianju
仙游	xianyou
代县	daixian
仪征	yizheng
仪陇	yilong
仲巴	zhongba
仲恺区	zhongkaiqu
任丘	renqiu
任县	renxian
任城	rencheng
企石	qishi
伊吾	yiwu
伊宁	yining
伊川	yichuan
伊春区	yichun
伊通	yitong
伊金霍洛	yijinhuoluo
伍家岗	wujiagang
休宁	xiuning
会东	huidong
会同	huitong
会宁	huining
会昌	huichang
会泽	huize
会理	huili
伽师	jiashi
余姚	yuyao
余干	yugan
余庆	yuqing
余杭	yuhang
余江	yujiang
佛冈	fogang
佛坪	foping
佛子山	fozishan
佳县	jiaxian
依兰	yilan
依安	yian
侯马	houma
保康	baokang
保德	baode
保靖	baojing
信丰	xinfeng
信宜	xinyi
信州	xinzhou
修文	xiuwen
修武	xiuwu
修水	xiushui
候口	houkou
偃师	yanshi
偏关	pianguan
元坝	yuanba
元宝	yuanbao
元宝山	yuanbaoshan
元朗区	yuanlang
元氏	yuanshi
元江	yuanjiang
元谋	yuanmou
元阳	yuanyang
光山	guangshan
光明新区	guangmingxinqu
光泽	guangze
克东	kedong
克井	kejing
克什克腾	keshinketeng
克山	keshan
克拉玛依区	kelamayi
兖州	yanzhou
全南	quannan
全州	quanzhou
全椒	quanjiao
八公山	bagongshan
八宿	baxiu
八步	babu
八道江区	badaojiangqu
公主岭	gongzhuling
公安	gongan
六合	liuhe
六枝特区	liuzhite
兰坪	lanping
兰山	lanshan
兰溪	lanxi
兰考	lankao
兰西	lanxi
共和	gonghe
关岭	guanling
兴业	xingye
兴义	xingyi
兴仁	xingren
兴化	xinghua
兴县	xingxian
兴和	xinghe
兴国	xingguo
兴城	xingcheng
兴宁	xingning
兴安	xingan
兴宾	xingbin
兴山	xingshan
兴平	xingping
兴庆	xingqing
兴文	xingwen
兴海	xinghai
兴隆	xinglong
兴隆台	xinglongtai
其他	qita
其他堂区	qitatang
其他市县	qitashixian
其盖麦旦	qigaimaidan
冀州	jizhou
内丘	neiqiu
内乡	neixiang
内黄	neihuang
册亨	ceheng
冕宁	mianning
军垦路街道	junkenlujiedao
农安	nongan
冠县	guanxian
冲山镇	chongshanzhen
冷水江	lengshuijiang
冷水滩	lengshuitan
冷湖行委	lenghuhangwei
净月	jingyue
净潭	jingtan
准格尔	zhungeer
凉城	liangcheng
凉州	liangzhou
凌云	lingyun
凌河	linghe
凌海	linghai
凌源	lingyuan
凤冈	fenggang
凤凰	fenghuang
凤凰岛	fenghuangdao
凤县	fengxian
凤台	fengtai
凤城	fengcheng
凤山	fengshan
凤岗	fenggang
凤庆	fengqing
凤泉	fengquan
凤翔	fengxiang
凤阳	fengyang
凭祥	pingxiang
凯里	kaili
分宜	fenyi
刚察	gangcha
利川	lichuan
利津	lijin
利辛	lixin
利通	litong
r河	louhe
前进	qianjin
前郭尔罗斯	qianguoerluosi
剑川	jianchuan
剑河	jianhe
剑阁	jiange
加查	jiacha
加格达奇	jiagedaqi
务川	wuchuan
勃利	boli
勉县	mianxian
勐海	menghai
勐腊	mengla
包河	baohe
化州	huazhou
化德	huade
化隆	hualong
北京周边	beijingzhoubian
北仑	beilun
北关	beiguan
北区	beiqu
北城新区	beichengxinqu
北塔	beita
北塘	beitang
北宁	beining
北安	beian
北川	beichuan
北市区	beishi
北戴河区	beidaihe
北林	beilin
北泉	beiquan
北流	beiliu
北海	beihai
北湖	beihu
北碚	beibei
北票	beipiao
北辰	beichen
北道	beidao
千山	qianshan
千阳	qianyang
华亭	huating
华县	huaxian
华坪	huaping
华宁	huaning
华安	huaan
华容	huarong
华池	huachi
华蓥	huaying
华阴	huayin
华龙	hualong
卓尼	zhuoni
卓资	zhuozi
单县	danxian
南丰	nanfeng
南丹	nandan
南乐	nanle
南京周边	nanjingzhoubian
南关	nanguan
南区	nanqu
南华	nanhua
南县	nanxian
南口街道	nankoujiedao
南召	nanzhao
南和	nanhe
南圣镇	nanshengzhen
南城	nancheng
南堡开发区	nanpukaifa
南头	nantou
南安	nanan
南宫	nangong
南山	nanshan
南岔	nancha
南岗	nangang
南岳	nanyue
南岸	nanan
南川	nanchuan
南市区	nanshi
南康	nankang
南开	nankai
南昌县	nanchang
南明	nanming
南朗	nanlang
南木林	nanmulin
南汇	nanhui
南江	nanjiang
南沙	nansha
南浔	nanxun
南海	nanhai
南涧	nanjian
南湖	nanhu
南溪	nanxi
南漳	nanzhang
南澳	nanao
南皮	nanpi
南票	nanpiao
南芬	nanfen
南谯	nanqiao
南郊	nanjiao
南郑	nanzheng
南部	nanbu
南长	nanchang
南陵	nanling
南雄	nanxiong
南靖	nanjing
博乐	bole
博兴	boxing
博山	boshan
博湖	bohu
博爱	boai
博白	bobai
博罗	boluo
博野	boye
卢市	lushi
卢氏	lushi
卢湾	luwan
卢龙	lulong
卧龙	wolong
卫东	weidong
卫滨	weibin
卫辉	weihui
印台	yintai
印江	yinjiang
即墨	jimo
历下	lixia
历城	licheng
厚街	houjie
原州	yuanzhou
原平	yuanping
原阳	yuanyang
友好	youhao
友谊	youyi
双台子	shuangtaizi
双城	shuangcheng
双塔	shuangta
双峰	shuangfeng
双柏	shuangbai
双桥	shuangqiao
双桥区	shuangqiao
双江	shuangjiang
双流	shuangliu
双清	shuangqing
双湖	shuanghu
双滦区	shuangluan
双牌	shuangpai
双辽	shuangliao
双阳	shuangyang
叙永	xuyong
叠彩	diecai
古丈	guzhang
古交	gujiao
古冶区	guye
古县	guxian
古城	gucheng
古塔	guta
古浪	gulang
古田	gutian
古蔺	gulin
古镇	guzhen
句容	jurong
召陵	zhaoling
台儿庄	taierzhuang
台前	taiqian
台安	taian
台山	taishan
台江	taijiang
右江	youjiang
右玉	youyu
叶县	yexian
叶城	yecheng
合作	hezuo
合山	heshan
合川	hechuan
合水	heshui
合江	hejiang
合浦	hepu
合阳	heyang
吉利	jili
吉县	jixian
吉安县	jianxian
吉州	jizhou
吉木乃	jimunai
吉木萨尔	jimusaer
吉水	jishui
吉隆	jilong
吉首	jishou
同仁	tongren
同安	tongan
同德	tongde
同心	tongxin
同江	tongjiang
名山	mingshan
吐鲁番市	tulufan
向阳	xiangyang
君山	junshan
含山	hanshan
启东	qidong
吴中	wuzhong
吴兴	wuxing
吴堡	wubao
吴川	wuchuan
吴桥	wuqiao
吴江	wujiang
吴起	wuqi
呈贡	chenggong
周宁	zhouning
周村	zhoucun
周矶	zhouji
周至	zhouzhi
呼中	huzhong
呼图壁	hutubi
呼玛	huma
和县	hexian
和布克赛尔	hebukesaier
和平	heping
和政	hezheng
和林格尔	helingeer
和田县	hetianxian
和田市	hetian
和硕	heshuo
和静	hejing
和顺	heshun
和龙	helong
咸丰	xianfeng
咸安	xianan
哈密市	hami
哈巴河	habahe
响水	xiangshui
唐县	tangxian
唐河	tanghe
唐海	tanghai
商南	shangnan
商城	shangcheng
商州	shangzhou
商水	shangshui
商河	shanghe
商都	shangdou
喀什市	kashi
喀喇沁	kalaqin
喀喇沁左翼	kalaqinzuoyi
喀拉拜勒镇	kalabailezhen
喜德	xide
嘉善	jiashan
嘉定	jiading
嘉模堂	jiamotang
嘉祥	jiaxiang
嘉禾	jiahe
嘉荫	jiayin
嘉陵	jialing
嘉鱼	jiayu
嘉黎	jiali
噶尔	gaer
囊谦	nangqian
四会	sihui
四子王	siziwang
四方	sifang
四方台	sifangtai
回民	huimin
团场	tuanchang
团风	tuanfeng
园区	yuanqu
园林	yuanlin
围场	weichang
固始	gushi
固安	guan
固镇	guzhen
固阳	guyang
图们	tumen
图木休克	tumuxiuke
图木舒克周边	tumushukezhoubian
图木舒克市区	tumushukeshiqu
土默特右	tumoteyou
土默特左	tumotezuo
圣安多尼堂	shenganduonitang
圣方济各堂	shengfangjigetang
坊子	fangzi
坡头	potou
坦洲	tanzhou
坪山新区	pingshanxinqu
垣曲	yuanqu
垦利	kenli
垫江	dianjiang
桥	yongqiao
城东	chengdong
城中	chengzhong
城关	chengguan
城北	chengbei
城区	chengqu
城厢	chengxiang
城口	chengkou
城固	chenggu
城子河	chengzihe
城步	chengbu
城西	chengxi
城阳	chengyang
堆龙德庆	duilongdeqing
塔什库尔	tashikuer
塔城市	tacheng
塔河	tahe
塘厦	tangsha
塘沽	tanggu
增城	zengcheng
墨江	muojiang
墨玉	moyu
墨竹工卡	mozhugongka
墨脱	motuo
壤塘	rangtang
壶关	huguan
复兴区	fuxing
夏县	xiaxian
夏河	xiahe
夏津	xiajin
夏邑	xiayi
多伦	duolun
多宝	duobao
多祥	duoxiang
大东	dadong
大东海	dadonghai
大丰	dafeng
大亚湾区	dayawanqu
大余	dayu
大关	daguan
大兴	daxing
大冶	daye
大化	dahua
大厂	dachang
大同	datong
大同县	datongxian
大名	daming
大城	dacheng
大埔	dapu
大埔区	dapu
大堂	datang
大姚	dayao
大宁	daning
大安	daan
大岭山	dalingshan
大峪	dayu
大悟	dawu
大新	daxin
大方	dafang
大朗	dalang
大柴旦行委	dachaidanhangwei
大武口	dawukou
大洼	dawa
大涌	dayong
大渡口	dadukou
大港	dagang
大理市	dali
大田	datian
大石桥	dashiqiao
大祥	daxiang
大竹	dazhu
大英	daying
大荔	dali
大观	daguan
大足	dazu
大通	datong
大通自治县	datongzizhixian
大邑	dayi
天元	tianyuan
天全	tianquan
天台	tiantai
天坛	tiantan
天宁	tianning
天山	tianshan
天峨	tiane
天峻	tianjun
天心	tianxin
天柱	tianzhu
天桥	tianqiao
天河	tianhe
天涯	tianya
天祝	tianzhu
天等	tiandeng
天镇	tianzhen
天长	tianzhang
太仆寺	taipusi
太仓	taicang
太和	taihe
太子河	taizihe
太平	taiping
太康	taikang
太湖	taihu
太白	taibai
太谷	taigu
头屯河	toutunhe
夷陵	yiling
夹江	jiajiang
奇台	qitai
奈曼	naiman
奉化	fenghua
奉新	fengxin
奉节	fengjie
奉贤	fengxian
奎屯	kuitun
奎文	kuiwen
如东	rudong
如意开发区	ruyikaifaqu
如皋	rugao
始兴	shixing
姚安	yaoan
姜堰	jiangyan
威信	weixin
威县	weixian
威宁	weining
威远	weiyuan
娄星	louxing
娄烦	loufan
婺城	wucheng
婺源	wuyuan
嫩江	nenjiang
子洲	zizhou
子长	zizhang
孙吴	sunwu
孝义	xiaoyi
孝南	xiaonan
孝昌	xiaochang
孟州	mengzhou
孟村	mengcun
孟津	mengjin
孟连	menglian
宁乡	ningxiang
宁化	ninghua
宁南	ningnan
宁县	ningxian
宁国	ningguo
宁城	ningcheng
宁安	ningan
宁强	ningqiang
宁明	ningming
宁晋	ningjin
宁武	ningwu
宁江区	ningjiangqu
宁河	ninghe
宁津	ningjin
宁洱	ninger
宁海	ninghai
宁蒗	ninglang
宁远	ningyuan
宁都	ningdou
宁阳	ningyang
宁陕	ningshan
宁陵	ningling
安丘	anqiu
安义	anyi
安乡	anxiang
安仁	anren
安化	anhua
安县	anxian
安吉	anji
安国	anguo
安图	antu
安塞	ansai
安多	anduo
安宁	anning
安定	anding
安居	anju
安岳	anyue
安平	anping
安新	anxin
安次区	anci
安泽	anze
安源	anyuan
安溪	anxi
安福	anfu
安达	anda
安远	anyuan
安阳县	anyang
安陆	anlu
安龙	anlong
宋洛	songluo
宏伟	hongwei
宕昌	dangchang
官渡	guandu
定兴	dingxing
定南	dingnan
定州	dingzhou
定日	dingri
定海	dinghai
定结	dingjie
定襄	dingxiang
定边	dingbian
定远	dingyuan
定陶	dingtao
宛城	wancheng
宜丰	yifeng
宜兴	yixing
宜君	yijun
宜城	yicheng
宜宾县	yibin
宜川	yichuan
宜州	yizhou
宜秀	yixiu
宜章	yizhang
宜良	yiliang
宜都	yidou
宜阳	yiyang
宜黄	yihuang
宝丰	baofeng
宝兴	baoxing
宝坻	baodi
宝塔	baota
宝安	baoan
宝山	baoshan
宝应	baoying
宝清	baoqing
宣化	xuanhua
宣化区	xuanhuaqu
宣威	xuanwei
宣州	xuanzhou
宣恩	xuanen
宣武	xuanwu
宣汉	xuanhan
容县	rongxian
容城	rongcheng
宽城	kuancheng
宽甸	kuandian
宾县	binxian
宾川	binzhou
宾阳	binyang
宿城区	suchengqu
宿松	susong
宿豫	suyu
密云	miyun
密山	mishan
富县	fuxian
富宁	funing
富川	fuchuan
富平	fuping
富拉尔基	fulaerji
富民	fumin
富源	fuyuan
富蕴	fuyun
富裕	fuyu
富锦	fujin
富阳	fuyang
富顺	fushun
寒亭	hanting
察哈尔右翼中	chahaeryouyizhong
察哈尔右翼前	chahaeryouyiqian
察哈尔右翼后	chahaeryouyihou
察布	chabu
察隅	chayu
察雅	chaya
寮步	liaobu
寻乌	xunwu
寻甸	xundian
寿光	shouguang
寿县	shouxian
寿宁	shouning
寿阳	shouyang
封丘	fengqiu
封开	fengkai
射洪	shehong
射阳	sheyang
将乐	jiangle
尉氏	weishi
尉犁	weili
小店	xiaodian
小板	xiaoban
小榄	xiaolan
小河	xiaohe
小河片	xiaohepian
小金	xiaojin
尖山	jianshan
尖扎	jianzha
尖草坪	jiancaoping
尚义	shangyi
尚志	shangzhi
尤溪	youxi
尧都	yaodou
尼勒克	nileke
尼木	nimu
尼玛	nima
居巢	juchao
屏南	pingnan
屏山	pingshan
屏边	pingbian
屯溪	tunxi
屯留	tunliu
屯门区	tuimen
山丹	shandan
山亭	shanting
山城	shancheng
山海关区	shanhaiguan
山阳	shanyang
山阴	shanyin
岐山	qishan
岑巩	cengong
岑溪	cenxi
岗巴	gangba
岚县	lanxian
岚山	lanshan
岚皋	langao
岢岚	kelan
岫岩	xiuyan
岭东	lingdong
岱山	daishan
岱岳	daiyue
岳口	lekou
岳塘	yuetang
岳普湖	yuepuhu
岳池	yuechi
岳西	yuexi
岳阳县	yueyangxian
岳阳楼	yueyanglou
岳麓	yuelu
岷县	minxian
峄城	yicheng
峡江	xiajiang
峨山	eshan
峨眉山	emeishan
峨边	ebian
峰峰矿区	fengfengkuang
崂山	laoshan
崆峒	kongtong
崇义	chongyi
崇仁	chongren
崇信	chongxin
崇安	chongan
崇川	chongchuan
崇州	chongzhou
崇文	chongwen
崇明	chongming
崇礼	chongli
崇阳	chongyang
崖城	yacheng
嵊州	shengzhou
嵊泗	shengsi
嵩县	songxian
嵩明	songming
巍山	weishan
川汇	chuanhui
工业园	gongyeyuan
工农	gongnong
工布江达	gongbujiangda
左云	zuoyun
左权	zuoquan
左贡	zuogong
巧家	qiaojia
巨野	juye
巨鹿	julu
巩义	gongyi
巩留	gongliu
巫山	wushan
巫溪	wuxi
巴东	badong
巴南	banan
巴塘	batang
巴州	bazhou
巴彦	bayan
巴林右	balinyou
巴林左	balinzuo
巴楚	bachu
巴里坤	balikun
巴青	baqing
巴马	bama
市中	shizhong
市北	shibei
市南	shinan
布尔津	buerjin
布拖	butuo
师宗	shizong
带岭	dailing
常宁	changning
常山	changshan
常平	changping
常熟	changshu
干河	ganhe
干驿	qianyi
平乐	pingle
平乡	pingxiang
平利	pingli
平南	pingnan
平原	pingyuan
平和	pinghe
平坝	pingba
平塘	pingtang
平安	pingan
平定	pingding
平山	pingshan
平川	pingchuan
平度	pingdu
平房	pingfang
平昌	pingchang
平果	pingguo
平桥	pingqiao
平武	pingwu
平江	pingjiang
平泉	pingquan
平湖	pinghu
平潭	pingtan
平罗	luoping
平舆	pingyu
平谷	pinggu
平远	pingyuan
平遥	pingyao
平邑	pingyi
平阳	pingyang
平阴	pingyin
平陆	pinglu
平顺	pingshun
平鲁	pinglu
幸福路街道	xingfulujiedao
广丰	guangfeng
广华	guanghua
广南	guangnan
广宁	guangning
广安区	guangan
广安城北	guanganchengbei
广安城南	guanganchengnan
广宗	guangzong
广平	guangping
广德	guangde
广昌	guangchang
广水	guangshui
广汉	guanghan
广河	guanghe
广灵	guangling
广阳区	guangyang
广陵	guangling
广饶	guangrao
庄河	zhuanghe
庄浪	zhuanglang
庆云	qingyun
庆元	qingyuan
庆城	qingcheng
庆安	qingan
庐山	lushan
庐江	lujiang
庐阳	luyang
库伦	kulun
库尔勒	kuerle
库尔勒周边	kuerlezhoubian
库车	kuche
应县	yingxian
应城	yingcheng
府谷	fugu
康乐	kangle
康保	kangbao
康县	kangxian
康定	kangding
康平	kangping
康马	kangma
廉江	lianjiang
延吉	yanji
延寿	yanshou
延川	yanchuan
延平	yanping
延庆	yanqing
延津	yanjin
延长	yanchang
建华	jianhua
建始	jianshi
建宁	jianning
建平	jianping
建德	jiande
建昌	jianchang
建水	jianshui
建湖	jianhu
建瓯	jianou
建邺	jianye
建阳	jianyang
开化	kaihua
开原	kaiyuan
开县	kaixian
开发	kaifa
开发区	kaifaqu
开封县	kaifeng
开平	kaiping
开平区	kaiping
开江	kaijiang
开福	kaifu
开远	kaiyuan
开阳	kaiyang
开鲁	kailu
弋江	yijiang
弋阳	yiyang
弓长岭	gongzhangling
张北	zhangbei
张家川	zhangjiachuan
张家港	zhangjiagang
张店	zhangdian
张沟	zhanggou
张港	zhanggang
张湾	zhangwan
张金	jinzhen
弥勒	mile
弥渡	midu
当涂	dangtu
当阳	dangyang
当雄	dangxiong
彝良	yiliang
彬县	binxian
彭场	pengchang
彭山	pengshan
彭州	pengzhou
彭市	pengshi
彭水	pengshui
彭泽	pengze
彭阳	pengyang
彰武	zhangwu
徐水	xushui
徐汇	xuhui
徐闻	xuwen
得荣	derong
循化	xunhua
微山	weishan
德令哈	delingha
德保	debao
德兴	dexing
德化	dehua
德城	decheng
德安	dean
德庆	deqing
德惠	dehui
德昌	dechang
德格	dege
德江	dejiang
德清	deqing
德钦	deqin
徽县	huixian
徽州	huizhou
志丹	zhidan
忠县	zhongxian
忻城	xincheng
忻府	xinfu
怀仁	huairen
怀宁	huaining
怀安	huaian
怀来	huailai
怀柔	huairou
怀远	huaiyuan
怀集	huaiji
思南	sinan
思明	siming
思礼	sili
思茅	maosi
恒山	hengshan
恩平	enping
恩施市	enshi
恭城	gongcheng
息县	xixian
息烽	xifeng
惠东	huidong
惠农	huinong
惠城	huicheng
惠安	huian
惠山	huishan
惠来	huilai
惠民	huimin
惠水	huishui
惠济	huiji
惠阳	huiyang
慈利	cili
慈溪	cixi
成华	chenghua
成县	chengxian
成安	chengan
成武	chengwu
戚墅堰	qishuyan
户县	huxian
房县	fangxian
房山	fangshan
扎兰屯	zhalantun
扎囊	zhanang
扎赉特	zhalaite
扎鲁特	zhalute
托克托	tuoketuo
托克逊	tuokexun
托里	tuoli
扬中	yangzhong
扶余	fuyu
扶沟	fugou
扶绥	fusui
扶风	fufeng
承德县	chengdexian
承留	chengliu
抚宁	funing
抚松县	fusongxian
抚远	fuyuan
抚顺县	fushun
拉孜	lazi
拖市	tuoshi
招远	zhaoyuan
拜城	baicheng
拜泉	baiquan
拱墅	gongshu
振兴	zhenxing
振安	zhenan
掇刀	duodao
措勤	cuoqin
措美	cuomei
揭东	jiedong
揭西	jiexi
攸县	youxian
改则	gaize
政务	zhengwu
政和	zhenghe
故城	gucheng
敖汉	aohan
敦化	dunhua
敦煌	dunhuang
文县	wenxian
文圣	wensheng
文安	wenan
文山市	wenshan
文峰	wenfeng
文成	wencheng
文水	wenshui
文登	wendeng
斗门	doumen
新丰	xinfeng
新乐	xinle
新乡县	xinxiang
新会	xinhui
新兴	xinxing
新化	xinhua
新北	xinbei
新区	xinqu
新华	xinhua
新华区	xinhua
新县	xinxian
新和	xinhe
新城	xincheng
新城区	xinchengqu
新宁	xinning
新安	xinan
新宾	xinbin
新密	xinmi
新巴尔虎右	xinbaerhuyou
新巴尔虎左	xinbaerhuzuo
新市	xinshi
新市区	xinshi
新干	xingan
新平	xinping
新建	xinjian
新抚	xinfu
新昌	xinchang
新晃	xinhuang
新林	xinlin
新民	xinmin
新沂	xinyi
新河	xinhe
新泰	xintai
新津	xinjin
新洲	xinzhou
新浦	xinpu
新源	xinyuan
新田	xintian
新站	xinzhan
新绛	xinjiang
新罗	xinluo
新荣	xinrong
新蔡	xincai
新邱	xinqiu
新邵	xinshao
新郑	xinzheng
新都	xindu
新野	xinye
新青	xinqing
新龙	xinlong
方城	fangcheng
方山	fangshan
方正	fangzheng
施甸	shidian
施秉	shibing
旅顺口	lvshunkou
旌德	jingde
旌阳	jingyang
无为	wuwei
无极	wuji
无棣	wuli
日喀则市	rikazeshi
日土	ritu
旬邑	xunyi
旬阳	xunyang
旺苍	wangcang
昂仁	angren
昂昂溪	angangxi
昆山	kunshan
昆都仑	kundoulun
昌乐	changle
昌北	changbei
昌吉市	changji
昌图	changtu
昌宁	changning
昌平	changping
昌江	changjiang
昌邑	changyi
昌邑区	changyiqu
昌都县	changduxian
昌黎	changli
明光	mingguang
明山	mingshan
明水	mingshui
明溪	mingxi
易县	yixian
易门	yimen
昔阳	xiyang
星子	xingzi
昭平	zhaoping
昭苏	zhaosu
昭觉	zhaojue
昭阳	zhaoyang
晋宁	jinning
晋安	jinan
晋州	jinzhou
晋江	jinjiang
晋源	jinyuan
普兰	pulan
普兰店	pulandian
普宁	puning
普安	puan
普定	puding
普格	puge
普陀	putuo
景东	jingdong
景县	jingxian
景宁	jingning
景泰	jingtai
景洪	jinghong
景谷	jinggu
晴隆	qinglong
曲周	quzhou
曲松	qusong
曲水	qushui
曲江	qujiang
曲江新区	qujiangxinqu
曲沃	quwo
曲阜	qufu
曲阳	quyang
曲麻莱	qumalai
曹县	caoxian
曹妃甸	caofeidian
曾都	cengdou
月湖	yuehu
朔城	shuocheng
朗县	langxian
望城	wangcheng
望奎	wangkui
望德堂	wangdetang
望江	wangjiang
望牛墩	wangniudun
望花	wanghua
望谟	wangmo
望都	wangdou
朝天	chaotian
朝阳	chaoyang
朝阳县	chaoyang
木兰	mulan
木垒	mulei
木里	muli
木鱼	muyu
未央	weiyang
本溪县	benxi
札达	zhada
杂多	zaduo
李沧	licang
杏花岭	xinghualing
杜尔伯特	duerbote
杜集	duji
杞县	qixian
来凤	laifeng
来安	laian
杨市	yangshi
杨林	yanglin
杨林尾	yanglinwei
杨浦	yangpu
杨陵	yangling
杭锦	hangjin
杭锦后	hangjinhou
松山	songshan
松山湖	songshanhu
松岭	songling
松柏	songbai
松桃	songtao
松江	songjiang
松溪	songxi
松滋	songzi
松潘	songpan
松阳	songyang
板芙	banfu
林口	linkou
林周	linzhou
林州	linzhou
林甸	lindian
林芝县	linzhixian
林西	linxi
枝江	zhijiang
枞阳	congyang
枣强	zaoqiang
枣阳	zaoyang
柏乡	baixiang
柘城	zhecheng
柘荣	zherong
柞水	zhashui
柯坪	keping
柯城	kecheng
柳北	liubei
柳南	liunan
柳城	liucheng
柳林	liulin
柳江	liujiang
柳河	liuhe
栖霞	qixia
株洲县	zhuzhou
根河	genhe
格尔木	geermu
栾城	luancheng
栾川	luanchuan
桂东	guidong
桂平	guiping
桂阳	guiyang
桃城区	taocheng
桃山	taoshan
桃江	taojiang
桃源	taoyuan
桐乡	tongxiang
桐城	tongcheng
桐庐	tonglu
桐柏	tongbai
桐梓	tongzi
桑日	sangri
桑植	sangzhi
桓仁	huanren
桓台	huantai
桥东	qiaodong
桥东区	qiaodong
桥头	qiaotou
桥西	qiaoxi
桥西区	qiaoxi
桦南	huanan
桦川	huachuan
桦甸	huadian
梁园	liangyuan
梁子湖	liangzihu
梁山	liangshan
梁平	liangping
梁河	lianghe
梅列	meilie
梅县	meixian
梅江	meijiang
梅河口	meihekou
梅里斯	meilisi
梓潼	zitong
梨树	lishu
椒江	jiaojiang
楚州	chuzhou
楚雄市	chuxiong
榆中	yuzhong
榆树	yushu
榆次	yuci
榆社	yushe
榆阳	yuyang
榕城	rongcheng
榕江	rongjiang
槐荫	huaiyin
樊城	fancheng
樟木头	zhangmutou
樟树	zhangshu
横县	hengxian
横山	hengshan
横峰	hengfeng
横林	henglin
横栏	henglan
横沥	hengli
歙县	xixian
正宁	zhengning
正安	zhengan
正定	zhengding
正蓝	zhenglan
正镶白	zhengxiangbai
正阳	zhengyang
武义	wuyi
武乡	wuxiang
武侯	wuhou
武冈	wugang
武功	wugong
武城	wucheng
武夷山	wuyishan
武宁	wuning
武安区	wuan
武定	wuding
武宣	wuxuan
武山	wushan
武川	wuchuan
武平	wuping
武强	wuqiang
武昌	wuchang
武江	wujiang
武清	wuqing
武穴	wuxue
武胜	wusheng
武进	wujin
武邑	wuyixian
武都	wudou
武陟	wuzhi
武陵	wuling
武陵源	wulingyuan
武隆	wulong
武鸣	wuming
殷都	yindou
比如	biru
毕节市	bijie
毛嘴	maozui
毛阳镇	maoyangzhen
民丰	minfeng
民乐	minle
民众	minzhong
民勤	minqin
民和	minhe
民权	minquan
水城	shuicheng
水富	shuifu
水磨沟	shuimogou
永丰	yongfeng
永仁	yongren
永修	yongxiu
永兴	yongxing
永吉	yongji
永和	yonghe
永善	yongshan
永嘉	yongjia
永城	yongcheng
永宁	yongning
永安	yongan
永安坝	yonganba
永定	yongding
永寿	yongshou
永川	yongchuan
永平	yongping
永年	yongnian
永康	yongkang
永德	yongde
永新	yongxin
永昌	yongchang
永春	yongchun
永泰	yongtai
永济	yongji
永清	yongqing
永登	yongdeng
永福	yongfu
永胜	yongsheng
永靖	yongjing
永顺	yongshun
汇川	huichuan
汉南	hannan
汉台	hantai
汉寿	hanshou
汉川	hanchuan
汉沽	hangu
汉沽农场	hangunongchang
汉源	hanyuan
汉滨	hanbin
汉阳	hanyang
汉阴	hanyin
汝南	runan
汝城	rucheng
汝州	ruzhou
汝阳	ruyang
江东	jiangdong
江北	jiangbei
江华	jianghua
江南	jiangnan
江口	jiangkou
江城	jiangcheng
江夏	jiangxia
江孜	jiangzi
江宁	jiangning
江安	jiangan
江山	jiangshan
江岸	jiangan
江川	jiangchuan
江州	jiangzhou
江干	jianggan
江永	jiangyong
江汉	jianghan
江油	jiangyou
江津	jiangjin
江海	jianghai
江源区	jiangyuanqu
江达	jiangda
江都	jiangdou
江阳	jiangyang
江阴	jiangyin
江陵	jiangling
汤原	tangyuan
汤旺河	tangwanghe
汤阴	tangyin
汨罗	miluo
汪场	wangchang
汪清	wangqing
汶上	wenshang
汶川	wenchuan
汽车城	qichecheng
汾西	fenxi
汾阳	fenyang
沁县	qinxian
沁园	qinyuan
沁水	qinshui
沁源	qinyuan
沁阳	qinyang
沂南	yinan
沂水	yishui
沂源	yiyuan
沅江	yuanjiang
沅陵	yuanling
沈丘	shenqiu
沈北	shenbei
沈河	shenhe
沌口开发区	jingjijishukaifaqu
沐川	muchuan
沔城	miancheng
沙依巴克	shayibake
沙县	shaxian
沙嘴	shazui
沙坡头	shapotou
沙坪坝	shapingba
沙市	shashi
沙河	shahe
沙河口	shahekou
沙洋	shayang
沙湖	sanhu
沙湾	shawan
沙溪	shaxi
沙田	shatian
沙田区	shatian
沙雅	shaya
沛县	peixian
沣渭新区	fengweixinqu
沧县	cangxian
沧浪	canglang
沧源	cangyuan
沭阳	shuyang
河东	hedong
河北	hebei
河南	henan
河口	hekou
河曲	hequ
河津	hejin
河西	hexi
河间	hejian
油尖旺区	youjianwang
油田	youtian
治多	zhiduo
沽源	guyuan
沾化	zhanhua
沾益	zhayi
沿河	yanhe
沿滩	yantan
泉山	quanshan
泉港	quangang
泊头	botou
泌阳	miyang
法库	faku
泗县	sixian
泗水	sishui
泗洪	sihong
泗阳	siyang
波密	bomi
泰兴	taixing
泰和	taihe
泰宁	taining
泰山	taishan
泰来	tailai
泰顺	taishun
泸县	luxian
泸定	luding
泸水	lushui
泸溪	luxi
泸西	luxi
泽口	zekou
泽州	zezhou
泽库	zeku
泽普	zepu
泾县	jingxian
泾川	jingchuan
泾源	jingyuan
泾阳	jingyang
洋县	yangxian
洛南	luonan
洛宁	luoning
洛川	luochuan
洛扎	luozha
洛江	luojiang
洛浦	luopu
洛隆	luolong
洛龙	luolong
洞口	dongkou
洞头	dongtou
津南	jinnan
津市	jinshi
洪山	hongshan
洪梅	hongmei
洪江	hongjiang
洪泽	hongze
洪洞	hongdong
洪湖	honghu
洪雅	hongya
洮北区	taobeiqu
洮南	taonan
洱源	eryuan
浈江	zhenjiang
负	shihe
济水	jishui
济阳	jiyang
浏阳	liuyang
哄	chanba
浑南	hunnan
浑源	hunyuan
浔阳	xunyang
浚县	junxian
浠水	xishui
浦东	pudongxinqu
浦北	pubei
浦口	pukou
浦城	pucheng
浦江	pujiang
浩口	haokou
浪卡子	langkazi
浮山	fushan
浮梁	fuliang
海丰	haifeng
海伦	hailun
海兴	haixing
海勃湾	haibowan
海南	hainan
海原	haiyuan
海城	haicheng
海宁	haining
海安	haian
海州	haizhou
海拉尔	hailaer
海晏	haiyan
海曙	haishu
海林	hailin
海棠湾	haitangwan
海沧	haicang
海淀	haidian
海港区	haigang
海港开发区	haigangkaifa
海珠	haizhu
海盐	haiyan
海门	haimen
海阳	haiyang
海陵	hailing
涉县	shexian
涞水	laishui
涞源	laiyuan
涟水	lianshui
涟源	lianyuan
涡阳	woyang
润州	runzhou
涧西	jianxi
涪城	fucheng
涪陵	fuling
涵江	hanjiang
涿州	zhuozhou
涿鹿	zhuolu
淄川	zichuan
淅川	xichuan
淇县	qixian
淇滨	qibin
淮上	huaishang
淮滨	huaibin
淮阳	huaiyang
淮阴	huaiyin
深州	shenzhen
深水肚	shengshuibu
深泽	shenze
淳化	chunhua
淳安	chunan
清丰	qingfeng
清原	qingyuan
清城	qingcheng
清徐	qingxu
清新	qingxin
清水	qingshui
清水河	qingshuihe
清河	qinghe
清河门	qinghemen
清流	qingliu
清浦	qingpu
清涧	qingjian
清溪	qingxi
清苑	qingyuan
清镇	qingzhen
渑池	mianchi
渔洋	yuyang
渔薪	yuxin
渝中	yuzhong
渝北	yubei
渝水	yushui
渠县	quxian
温县	wenxian
温宿	wensu
温岭	wenling
温江	wenjiang
温泉	wenquan
渭城	weicheng
渭源	weiyuan
渭滨	weibin
港北	gangbei
港南	gangnan
港口	gangkou
港闸	gangzha
游仙	youxian
湄潭	meitan
湖口	hukou
湖滨	hubin
湖里	huli
湘东	xiangdong
湘乡	xiangxiang
湘桥	xiangqiao
湘潭县	xiangtan
湘阴	xiangyin
湛河	zhanhe
湟中	huangzhong
湟源	huangyuan
湾仔区	wanzai
湾里	wanli
溆浦	xupu
源城	yuancheng
源汇	yuanhui
溧水	lishui
溧阳	liyang
溪湖	xihu
滑县	huaxian
滕州	tengzhou
满城	mancheng
满洲里	manzhouli
滦南	luannan
滦县	luanxian
滦平	luanping
滨城	bincheng
滨江	binjiang
滨海	binhai
滨海新区	binhaixinqu
滨湖	binhu
滴道	didao
漠河	mohe
漳县	zhangxian
漳平	zhangping
漳浦	zhangpu
漾濞	yangbi
潍城	weicheng
潘集	panji
潜山	qianshan
潞城	lucheng
潞西	luxi
潢川	huangchuan
潮南	chaonan
潮安	chaoan
潮阳	chaoyang
潼关	tongguan
潼南	tongnan
澄城	chengcheng
澄江	chengjiang
澄海	chenghai
澜沧	lancang
澧县	lixian
濉溪	suixi
濠江	haojiang
濮阳县	puyang
e河	chanhe
灌云	guanyun
灌南	guannan
灌阳	guanyang
灞桥	baqiao
火炬	huoju
灯塔	dengta
灵丘	lingqiu
灵台	lingtai
灵宝	lingbao
灵寿	lingshou
灵山	lingshan
灵川	lingchuan
灵武	lingwu
灵璧	lingbi
灵石	lingshi
炉霍	luhuo
炎陵	yanling
点军	dianjun
烈山	lieshan
焉耆	yanqi
熊口	xiongkou
燕郊	yanjiao
爱民	aimin
爱辉	aihui
牙克石	yakeshi
牟定	mouding
牟平	mouping
牡丹	mudan
牧野	muye
特克斯	tekesi
犍为	jianwei
独山	dushan
独山子	dushanzi
狮子山	shizishan
V亭	xiaoting
献县	xianxian
玄武	xuanwu
玉屏	yuping
玉山	yushan
玉州	yuzhou
玉树县	yushuxian
玉泉	yuquan
玉环	yuhuan
玉田	yutian
玉门	yumen
玉龙	yulong
王场	wangchang
王屋	wangwu
王益	wangyi
玛多	maduo
玛曲	maqu
玛沁	maqin
玛纳斯	manasi
环县	huanxian
环江	huanjiang
环翠	huancui
珙县	gongxian
珠山	zhushan
珠晖	zhuhui
班戈	bange
班玛	banma
珲春	huichun
琅琊	langya
理县	lixian
理塘	litang
琼山	qiongshan
琼结	qiongjie
瑞丽	ruili
瑞安	ruian
瑞昌	ruichang
瑞金	ruijin
瑶海	yaohai
璧山	bishan
瓜州	guazhou
瓦房店	wafangdian
瓮安	wengan
瓯海	ouhai
甘井子	ganjingzi
甘南	gannan
甘孜县	ganzi
甘州	ganzhou
甘德	gande
甘泉	ganquan
甘洛	ganluo
甘谷	gangu
甬江	yongjiang
田东	tiandong
田家庵	tianjiaan
田林	tianlin
田独	tiandu
田阳	tianyang
申扎	anzha
电白	dianbai
界首	jieshou
留坝	liuba
略阳	lueyang
番禺	fanyu
番阳镇	fanyangzhen
疏勒	shule
疏附	shufu
登封	dengfeng
白下	baixia
白云	baiyun
白云矿	baiyunkuang
白塔	baita
白朗	bailang
白水	baishui
白河	baihe
白玉	baiyu
白碱滩	baijiantan
白银区	baiyinqu
皂市	zaoshi
皇姑	huanggu
皋兰	gaolan
皮山	pishan
皮恰克松地	piqiakesongdi
盂县	yuxian
盈江	yingjiang
盐亭	yanting
盐山	yanshan
盐池	yanchi
盐津	yanjin
盐湖	yanhu
盐源	yanyuan
盐田	yantian
盐边	yanbian
盐都	yandou
监利	jianli
盖州	gaizhou
盖米里克	gaimilike
盘县	panxian
盘山	panshan
盘龙	panlong
盱眙	xuyi
相城	xiangcheng
相山	xiangshan
眉县	meixian
睢县	suixian
睢宁	suining
睢阳	suiyang
石台	shitai
石城	shicheng
石屏	shiping
石岐	shiqi
石峰	shifeng
石拐	shiguai
石排	shipai
石景山	shijingshan
石林	shilin
石柱	shizhu
石棉	shimian
石楼	shilou
石河	shihe
石河子乡	shihezixiang
石泉	shiquan
石渠	shiqu
石狮	shishi
石碣	shijie
石门	shimen
石阡	shiqian
石首	shishou
石鼓	shigu
石龙	shilong
矿区	kuangqu
砀山	dangshan
砚山	yanshan
~口	qiaokou
确山	queshan
碌曲	luqu
碑林	beilin
碾子山	nianzishan
磁县	cixian
磐安	panan
磐石	panshi
磴口	dengkou
礼县	lixian
礼泉	liquan
社旗	sheqi
祁东	qidong
祁县	qixian
祁连	qilian
祁门	qimen
祁阳	qiyang
神木	shenmu
神池	shenchi
神湾	shenwan
祥云	xiangyun
禄丰	lufeng
禄劝	luquan
禅城	chancheng
福安	fuan
福山	fushan
福泉	fuquan
福海	fuhai
福清	fuqing
福田	futian
福贡	fugong
福鼎	fuding
禹会	yuhui
禹城	yucheng
禹州	yuzhou
禹王台	yuwangtai
离岛区	lidao
离石	lishi
秀山	xiushan
秀屿	xiuyu
秀峰	xiufeng
秀洲	xiuzhou
秀英	xiuying
科创园	kechuangyuan
科尔沁	keerqin
科尔沁右翼中	keerqinyouyizhong
科尔沁右翼前	keerqinyouyiqian
科尔沁左翼中	keerqinzuoyizhong
科尔沁左翼后	keerqinzuoyihou
秦城	qinzhou
秦安	qinan
秦淮	qinhuai
秦都	qindou
秭归	zigui
积玉口	jiyukou
积石山	jishishan
称多	chengduo
稷山	jishan
稻城	daocheng
穆棱	muleng
突泉	tuquan
立山	lishan
站前	zhanqian
竟陵	jingling
章丘	zhangqiu
章贡	zhanggong
端州	duanzhou
竹山	zhushan
竹根滩	zhugentan
竹溪	zhuxi
策勒	cele
筠连	junlian
简阳	jianyang
管城	guanchenghuizu
米东	midong
米易	miyi
米林	milin
米泉	miquan
米脂	mizhi
类乌齐	leiwuqi
精河	jinghe
索县	suoxian
紫云	ziyun
紫金	zijin
紫阳	ziyang
綦江	qijiang
繁峙	fanzhi
繁昌	fanchang
红原	hongyuan
红古	honggu
红坪	hongping
红塔	hongta
红安	hongan
红山	hongshan
红岗	honggang
红旗	hongqi
红星	hongxing
红桥	hongqiao
红河县	honghe
红花岗	honghuagang
红谷滩新区	honggutanxinqu
纳溪	naxi
纳雍	nayong
细河	xihe
织金	zhijin
绍兴县	shaoxing
经区	jingqu
经开	jingkai
经开区	jingkaiqu
经济开发区	jingjikaifa
绛县	jiangxian
绥中	suizhong
绥宁	suining
绥德	suide
绥棱	suileng
绥江	suijiang
绥滨	suibin
绥芬河	suifenhe
绥阳	suiyang
绩溪	jixi
维扬	weiyang
维西	weixi
绵竹	mianzhu
绿园	lvyuan
绿春	lvchun
缙云	jinyun
罗城	luocheng
罗定	luoding
罗山	luoshan
罗平	luoping
罗庄	luozhuang
罗江	luojiang
罗湖	luohu
罗源	luoyuan
罗田	luotian
罗甸	luodian
美兰	meilan
美姑	meigu
美溪	meixi
翁源	wengyuan
翁牛特	wengniute
翔安	xiangan
翠屏	cuiping
翠峦	cuiluan
翼城	yicheng
耀州	yaozhou
老城	laocheng
老新	laoxin
老河口	laohekou
老街	laojie
老边	laobian
耒阳	leiyang
耿马	gengma
聂拉木	nielamu
聂荣	nierong
肃北	subei
肃南	sunan
肃宁	suning
肃州	suzhou
肇东	zhaodong
肇州	zhaozhou
肇源	zhaoyuan
肥东	feidong
肥乡	feixiang
肥城	feicheng
肥西	feixi
育才	yucai
胡场	huchang
胡市	hushi
胶南	jiaonan
胶州	jiaozhou
腾冲	tengchong
自流井	ziliujing
舒兰	shulan
舒城	shucheng
舞钢	wugang
舞阳	wuyang
舟曲	zhouqu
船山	chuanshan
船营区	chuanyingqu
良庆	liangqing
色达	seda
芒康	mangkang
芗城	xiangcheng
芙蓉	furong
芜湖县	wuhuxian
芝罘	zhifu
芦台农场	lutainongchang
芦山	lushan
芦淞	lusong
芦溪	luxi
芮城	ruicheng
花地玛堂	huadimatang
花垣	huayuan
花山	huashan
花溪	huaxi
花都	huadou
芷江	zhijiang
苍南	cangnan
苍山	cangshan
苍梧	cangwu
苍溪	cangxi
苏仙	suxian
苏家屯	sujiatun
苏尼特右	suniteyou
苏尼特左	sunitezuo
若尔盖	ruoergai
若羌	ruoqiang
英吉沙	yingjisha
英山	yingshan
英德	yingde
茂南	maonan
茂县	maoxian
茂港	maogang
范县	fanxian
茄子河	qiezihe
茅箭	maojian
茌平	chiping
茫崖行委	mangyahangwei
茶山	chashan
茶陵	chaling
荃湾区	quanwan
荆州区	jingzhou
荔城	licheng
荔波	libo
荔浦	lipu
荔湾	liwan
荣县	rongxian
荣成	rongcheng
荣昌	rongchang
荥经	yingjing
荥阳	xingyang
荷塘	hetang
莎车	shache
莒南	junan
莒县	juxian
莘县	shenxian
莞城	guancheng
莫力达瓦达翰尔族	molidawadahanerzu
莱城	laicheng
莱山	laishan
莱州	laizhou
莱西	laixi
莱阳	laiyang
莲湖	lianhu
莲花	lianhua
莲都	liandu
获嘉	huojia
萝北	luobei
萝岗	luogang
营山	yingshan
萧县	xiaoxian
萧山	xiaoshan
萨嘎	saga
萨尔图	saertu
萨迦	sajia
葵青区	kuiqing
蒋场	jiangchang
蒙城	mengcheng
蒙山	mengshan
蒙自	mengzi
蒙阴	mengyin
蒲县	puxian
蒲城	pucheng
蒲江	pujiang
蒸湘	zhengxiang
蓝山	lanshan
蓝田	lantian
蓟县	jixian
蓬安	pengan
蓬江	pengjiang
蓬溪	pengxi
蓬莱	penglai
蔚县	weixian
蔡甸	caidian
蕉城	jiaocheng
蕉岭	jiaoling
蕲春	qichun
薛城	xuecheng
藁城	gaocheng
藤县	tengxian
虎林	hulin
虎门	humen
虞城	yucheng
虹口	hongkou
蚌山	bengshan
蛟河	jiaohe
蜀山	shushan
蝶山	dieshan
融安	rongan
融水	rongshui
蠡县	lixian
行唐	xingtang
衡东	hengdong
衡南	hengnan
衡山	hengshan
衡阳县	hengyang
衢江	qujiang
袁州	yuanzhou
裕华	yuhua
裕安	yuan
裕民	yumin
襄垣	xiangyuan
襄城	xiangcheng
襄州	xiangyang
襄汾	xiangfen
西丰	xifeng
西乌珠穆沁	xiwuzhumuqin
西乡	xixiang
西乡塘	xixiangtang
西充	xichong
西区	xiqu
西华	xihua
西吉	xiji
西和	xihe
西固	xigu
西城	xicheng
西塞山	xisaishan
西夏	xixia
西安	xian
西安区	xianqu
西山	xishan
西岗	xigang
西峡	xixia
西峰	xifeng
西工	xigong
西市	xishi
西平	xiping
西昌	xichang
西林	xilin
西流河	xiliuhe
西湖	xihu
西畴	xichou
西盟	ximeng
西秀	xixiu
西贡区	xigong
西陵	xiling
西青	xiqing
覃塘	tantang
观塘区	guangtang
解放	jiefang
让胡路	ranghulu
讷河	nehe
许昌县	xuchang
诏安	zhaoan
诸城	zhucheng
诸暨	zhuji
调兵山	diaobingshan
谢家集	xiejiaji
谢岗	xiegang
谢通门	xietongmen
谯城	qiaocheng
谷城	gucheng
象山	xiangshan
象州	xiangzhou
贞丰	zhenfeng
贡井	gongjing
贡嘎	gongga
贡山	gongshan
贡觉	gongjiao
贵南	guinan
贵定	guiding
贵德	guide
贵池	guichi
贵溪	guixi
费县	feixian
贺兰	helan
贾汪	jiawang
资中	zizhong
资兴	zixing
资源	ziyuan
资溪	zixi
资阳	ziyang
赛罕	saihan
赞皇	zanhuang
赣县	ganxian
赣榆	ganyu
赤坎	chikan
赤城	chicheng
赤壁	chibi
赤水	chishui
赫山	heshan
赫章	hezhang
赵县	zhaoxian
越城	yuecheng
越秀	yuexiu
越西	yuexi
路北区	lubei
路南区	lunan
路桥	luqiao
轮台	luntai
轵城	zhicheng
辉南	huinan
辉县	huixian
辛集	xinji
辰溪	chenxi
边坝	bianba
辽中	liaozhong
辽阳县	liaoyang
达县	daxian
达坂城	dabancheng
达孜	dazi
达拉特	dalate
达日	dari
达茂	damao
迁安	qianan
迁西	qianxi
迎江	yingjiang
迎泽	yingze
运河区	yunhe
进贤	jinxian
远安	yuanan
连云	lianyun
连南	liannan
连城	liancheng
连山	lianshan
连州	lianzhou
连平	lianping
连江	lianjiang
迭部	diebu
逊克	xunke
通化县	tonghuaxian
通城	tongcheng
通山	tongshan
通川	tongchuan
通州	tongzhou
通榆	tongyu
通江	tongjiang
通河	tonghe
通海	tonghai
通海口	tonghai
通渭	tongwei
通许	tongxu
通道	tongdao
遂川	suichuan
遂平	suiping
遂昌	suichang
遂溪	suixi
道县	daoxian
道外	daowai
道孚	daofu
道	daorong
道真	daozhen
道里	daoli
遵义县	zunyixian
遵化	zunhua
邓州	dengzhou
邕宁	yongning
邗江	hanjiang
邛崃	qionglai
邢台县	xingtaixian
那坡	napo
那曲县	naquxian
邯山区	hanshan
邯郸县	handanxian
邱县	qiuxian
邳州	pizhou
邵东	shaodong
邵原	shaoyuan
邵武	shaowu
邵阳县	shaoyangxian
邹城	zoucheng
邹平	zouping
邻水	linshui
郁南	yvnan
郊区	jiaoqu
郎溪	langxi
郏县	jiaxian
郑东	zhengdong
郑场	zhengchang
郓城	yuncheng
郧县	yunxian
郧西	yunxi
郫县	pixian
郭河	guohe
郯城	tancheng
郸城	dancheng
都兰	doulan
都匀	douyun
都安	douan
都昌	douchang
都江堰	dujiangyan
郾城	yancheng
鄂伦春自治	elunchun
鄂城	echeng
鄂托克	etuoke
鄂托克前	etuokeqian
鄂温克族自治	ewenkezu
鄄城	juancheng
鄞州	yinzhou
鄢陵	yanling
鄯善	shanshan
鄱阳	poyang
酉阳	youyang
醴陵	liling
金东	jindong
金乡	jinxiang
金凤	jinfeng
金口河	jinkouhe
金台	jintai
金坛	jintan
金城江	jinchengjiang
金堂	jintang
金塔	jinta
金墩	jindun
金安	jinan
金家庄	jinjiazhuang
金寨	jinzhai
金山	jinshan
金山屯	jinshantun
金山开发区	jinshankaifaqu
金山桥开发区	jinshanqiaokaifaqu
金川	jinchuan
金川开发区	jinchuankaifaqu
金州	jinzhou
金平	jinping
金明	jinming
金桥开发区	jinqiaokaifaqu
金水	jinshui
金沙	jinsha
金湖	jinhu
金湾	jinwan
金溪	jinxi
金牛	jinniu
金秀	jinxiu
金银川路街道	jinyinchuanlujiedao
金门	jinmen
金阊	jinchang
金阳	jinyang
金阳新区	jinyangxin
钟山	zhongshan
钟楼	zhonglou
钟祥	zhongxiang
钢城	gangcheng
钦北	qinbei
钦南	qinnan
铁东	tiedong
铁东区	tiedongqu
铁力	tieli
铁山	tieshan
铁山港	tieshangang
铁岭县	tieling
铁西	tiexi
铁西区	tiexiqu
铁锋	tiefeng
铅山	qianshan
铜仁市	tongren
铜官山	tongguanshan
铜山	tongshan
铜梁	tongliang
铜陵县	tonglingxian
铜鼓	tonggu
银州	yinzhou
银海	yinhai
错那	cuona
锡山	xishan
锡林浩特	xilinhaote
锦屏	jinping
锦江	jinjiang
镇原	zhenyuan
镇坪	zhenping
镇宁	zhenning
镇安	zhenan
镇巴	zhenba
镇平	zhenping
镇康	zhenkang
镇江新区	zhenjiangxinqu
镇沅	zhenyuan
镇海	zhenhai
镇赉	zhenlai
镇远	zhenyuan
镇雄	zhenxiong
镜湖	jinghu
镜铁区	jingtie
镶黄	xianghuang
长丰	zhangfeng
长乐	changle
长兴	changxing
长垣	changyuan
长城区	changcheng
长每	changtangkou
长子	changzi
长宁	changning
长安	changan
长寿	changshou
长岛	changdao
长岭	changling
长武	changwu
长汀	changting
长沙县	changshaxian
长治县	zhangzhixian
长泰	changtai
长洲	zhangzhou
长海	changhai
长清	changqing
长白	zhangbai
长葛	zhangge
长阳	zhangyang
长顺	changshun
门头沟	mentougou
门源	menyuan
闵行	minhang
闸北	zhabei
闻喜	wenxi
闽侯	minhou
闽清	minqing
阆中	langzhong
阎良	yanliang
阜南	funan
阜城	fucheng
阜宁	funing
阜平	fuping
阜康	fukang
阜新县	fuxin
阜沙	fusha
防城	fangcheng
阳东	yangdong
阳信	yangxin
阳原	yangyuan
阳城	yangcheng
阳山	yangshan
阳新	yangxin
阳日	yangri
阳明	yangming
阳春	yangchun
阳曲	yangqu
阳朔	yangshuo
阳西	yangxi
阳谷	yanggu
阳高	yanggao
阿克塞	akesai
阿克苏市	akesu
阿克陶	aketao
阿勒泰市	aletai
阿合奇	aheqi
阿图什	atushi
阿坝县	aba
阿城	acheng
阿尔山	aershan
阿巴嘎	abaga
阿拉善右	alashanyou
阿拉善左	alashanzuo
阿拉尔周边	alaerzhoubian
阿瓦提	awati
阿荣	arong
阿鲁科尔沁	alukeerqin
陆丰	lufeng
陆川	luchuan
陆河	luhe
陆良	luliang
陇县	longxian
陇川	longchuan
陇西	longxi
陈仓	chencang
陈场	chenchang
陈巴尔虎	chenbaerhu
陕县	shanxian
陵县	lingxian
陵川	lingchuan
隆化	longhua
隆回	longhui
隆子	longzi
隆安	longan
隆尧	longyao
隆德	longde
隆昌	longchang
隆林	longlin
隆阳	longyang
隰县	xixian
雁塔	yanta
雁山	yanshan
雁峰	yanfeng
雁江	yanjiang
雄关区	xiongguan
雄县	xiongxian
雅江	yajiang
集宁	jining
集安	jian
集美	jimei
集贤	jixian
雨城	yucheng
雨山	yushan
雨湖	yuhu
雨花	yuhua
雨花台	yuhuatai
零陵	lingling
雷山	leishan
雷州	leizhou
雷波	leibo
霍城	huocheng
霍山	huoshan
霍州	huozhou
霍林郭勒	huolinguoleshi
霍邱	huoqiu
霞山	xiashan
霞浦	xiapu
霸州	bazhou
青云谱	qingyunpu
青冈	qinggang
青原	qingyuan
青县	qingxian
青山	qingshan
青山湖	qingshanhu
青川	qingchuan
青州	qingzhou
青松路街道	qingsonglujiedao
青河	qinghe
青浦	qingpu
青湖路街道	qinghulujiedao
青田	pingtian
青白江	qingbaijiang
青神	qingshen
青秀	qingxiu
青羊	qingyang
青铜峡	qingtongxia
青阳	qingyang
青龙	qinglong
靖宇县	jingyuxian
靖安	jingan
靖州	jingzhou
靖江	jingjiang
靖西	jingxi
靖边	jingbian
靖远	jingyuan
静乐	jingle
静宁	jingning
静安	jingan
静海	jinghai
革吉	geji
韩城	hancheng
韶山	shaoshan
项城	xiangcheng
顺义	shunyi
顺城	shuncheng
顺平	shunping
顺庆	shunqing
顺德	shunde
顺昌	shunchang
顺河	shunhe
颍上	yingshang
颍东	yingdong
颍州	yingzhou
颍泉	yingquan
额尔古纳	eerguna
额敏	emin
额济纳	ejina
风顺堂	fengshuntang
饶平	raoping
饶河	raohe
饶阳	raoyang
馆陶	guantao
香坊	xiangfang
香格里拉	xianggelila
香河	xianghe
香洲	xiangzhou
马关	maguan
马尔康	maerkang
马尾	mawei
马山	mashan
马村	macun
马湾	mawan
马边	mabian
马龙	malong
驿城	yicheng
高区	gaoqu
高县	gaoxian
高台	gaotai
高唐	gaotang
高坪	gaoping
高	gaobu
高安	gaoan
高密	gaomi
高州	gaozhou
高平	gaoping
高开区	gaokai
高新	gaoxin
高新区	gaoxinqu
高新园区	gaoxinyuanqu
高新西区	gaoxinxiqu
高明	gaoming
高淳	gaochun
高港	gaogang
高石碑	gaoshibei
高碑店	gaobeidian
高要	gaoyao
高邑	gaoyi
高邮	gaoyou
高阳	gaoyang
高陵	gaoling
高青	gaoqing
魏县	weixian
魏都	weidou
鱼台	yutai
鱼峰	yufeng
鲁山	lushan
鲁甸	ludian
鲅鱼圈	bayuquan
鲤城	licheng
鸠江	jiujiang
鸡东	jidong
鸡冠	jiguan
鸡泽	jize
鹤城	hecheng
鹤山	heshan
鹤峰	hefeng
鹤庆	heqing
鹰手营子	yingshouyingzi
鹿城	lucheng
鹿寨	luzhai
鹿泉	luquan
鹿邑	luyi
麒麟	qilin
麟游	linyou
麦盖提	maigaiti
麻城	macheng
麻山	mashan
麻栗坡	malipo
麻江	majiang
麻洋	mayang
麻涌	mayong
麻章	mazhang
麻阳	mayang
黄圃	huangpu
黄埔	huangpu
黄大仙区	huangdaxian
黄山区	huangshan
黄岛	huangdao
黄岩	huangyan
黄州	huangzhou
黄平	huangping
黄梅	huangmei
黄江	huangjiang
黄浦	huangpu
黄潭	huangtan
黄石港	huangshigang
黄陂	huangbei
黄陵	huangling
黄骅	huanghua
黄龙	huanglong
黎城	licheng
黎川	lichuan
黎平	liping
黎林	lilin
黑山	heishan
黑水	heishui
黔江	qianjiang
黔西	qianxi
黟县	yixian
鼎城	dingcheng
鼎湖	dinghu
鼓楼	gulou
齐河	qihe
龙井	longjing
龙亭	longting
龙凤	longfeng
龙华	longhua
龙华山	longhuanshan
龙南	longnan
龙口	longkou
龙城	longcheng
龙子湖	longzihu
龙安	longan
龙山	longshan
龙山区	longshanqu
龙岗	longgang
龙川	longchuan
龙州	longzhou
龙文	longwen
龙江	longjiang
龙沙	longsha
龙泉	longquan
龙泉驿	longquanyi
龙海	longhai
龙港	longgang
龙游	longyou
龙湖	longhu
龙湾	longwan
龙潭区	longtanqu
龙胜	longsheng
龙里	longli
龙门	longmen
龙陵	longling
龙马潭	longmatan
