204医院	204yiyuan
21世纪花园	21shijihuayuan
34中	34zhong
3536	3536
47街区	47jiequ
52街区	52jiequ
724地区	wenguan
CBD	CBD
SM附近	smfujin
一元路	yiyuan
一号桥	yihaoqiao
一品	yipin
一曼街	yimanjie
一汽大众	yiqidazhong
一碗水	yiwanshui
一经	yijing
一马路	yimalu
丁公路	dinggonglu
丁字桥	dingziqiao
丁字沽	dingzigu
丁家房	dingjiafang
丁桥	dingqiao
丁白路	dingbailu
丁蜀镇	dingshuzhen
丁香湖	dingxianghu
七七街	qiqijie
七宝	qibao
七星岗	qixinggang
七星桃源区	qixingtaoyuanqu
七星楼	qixinglou
七贤岭	qixianling
七都	qidu
七里堡	qilibao
七里塘	qilitang
七里山	qilishan
七里岗	qiligang
七里庄	qilizhuang
七里庙	qilimiao
七里海	qilihai
七里站	qilizhan
万东	wandong
万体馆	wantiguan
万佳	wanjia
万兴街	wanxing
万向汽车城	wanxiangqichecheng
万埠	wanbu
万宝	wanbao
万宝街	wanbaojie
万家	wanjia
万家丽	wanjiali
万寿	wanshou
万寿寺	wanshousi
万寿路	wanshoulu
万岁街	wansuijie
万年场	wannianchang
万春	wanchun
万松	wansong
万柳	wanliu
万江中心	wanjiangzhongxin
万泉	wanquan
万泉河	wanquanhe
万石镇	wanshizhen
万福街	wanfujie
万科城	wankecheng
万莲	wanlian
万达	wanda
万达广场	wandaguangchang
万通	wantong
万里城	wanlicheng
万顷沙	wanqingsha
万顺	wanshun
三一大道	sanyidadao
三元桥	sanyuanqiao
三元里	sanyuanli
三八广场	sanbaguangchang
三其	sanqi
三医院	sanyiyuan
三十里堡	sanshilipu
三叉街	sanchajie
三台子	santaizi
三合路	sanhelu
三和七街	sanheqijie
三和三街	sanhesanjie
三和东街	sanhedongjie
三和二街	sanheerjie
三和五街	sanhewujie
三和六街	sanheliujie
三和四街	sanhesijie
三和街	sanhejie
三圣	sansheng
三堡	sanpu
三塘	santang
三墙路	sanqianglu
三墩	sandun
三大动力	jiankanglu
三好街	sanhaojie
三孔桥街	sankongqiaojie
三孝口	sanxiaokou
三官庙	sanguanmiao
三岔	sancha
三峡广场	sanxiaguangchang
三工	sangong
三店	dongxihusandian
三店西路	sanjiadian
三星	shuangliusanxing
三条石	santiaoshi
三林	sanlin
三桥	sanqiao
三棵树	sanke
三槐路	sanhuailu
三汊河	sanchahe
三洞桥	sandongqiao
三涧堡	sanjianbao
三湘大市场	sanxiangdashichang
三溪	sanxi
三牌楼	sanpailou
三电	sandian
三界	sanjie
三经路	sanjinglu
三道堰	sandaoyan
三道街	sandaojie
三郎	sanlang
三里亭	sanliting
三里屯	sanlitun
三里庵	sanlian
三里村	sanlicun
三里河	sanlihe
三里街	sanlijie
三门坡	sanmenpo
三阳路	sanyanglu
三面船	sanmianchuan
三马路	sanmalu
三高路	sangaolu
三鹏广场	sanpengguangchang
上三路	shangsanlu
上下九	shangxiajiu
上下桥	shangxiaqiao
上五庄	shangwuzhuang
上仓	shangcang
上元大街	shangyuandajie
上兰	shanglan
上冲/前山	shangchongqianshan
上南新村	shangnanxincun
上园路	shangyuan
上地	shangdi
上坊	shangfang
上大	shangda
上大垅	shangdalong
上夼	shangkuang
上安	shangan
上尧	shangyao
上师大	shangshida
上庄	shangzhuang
上新庄	shangxinzhuang
上杭路	shanghanglu
上梅林	shangmeilin
上步	shangbu
上沙	shangsha
上派	shangpai
上海	shanghai
上海南站	shanghainanzhan
上海影城	shanghaiyingcheng
上海滩社区	shanghaitanshequ
上海路	shanghailu
上清寺	shangqingsi
上渡	shangdu
上甘	shanggan
上田路	shangtianlu
上社	shangshe
上窑	shangyao
上钢新村	shanggangxincun
上陡门	shangdoumen
上马	shangma
上马台	shangmatai
上马墩街道	shangmadunjiedao
下仓	xiacang
下伍旗	xiawuqi
下元	xiayuan
下初	xiachu
下吕浦	xialvpu
下塘	xiatang
下大垅	xiadalong
下应	xiaying
下朱庄	xiazhuzhuang
下梅林	xiameilin
下沙	xiasha
下淀	xiadian
下渡	xiadu
下渡路	xiadulu
下瓦房	xiawafang
下窑	xiayao
下窝头	xiawotou
下营	xiaying
下角	xiajiao
不老屯	bulaotun
世博广场	shiboguangchang
世博滨江	pudongshibobinjiang
世博片区	shibopianqu
世回尧	shihuiyao
世昌大道	shichangdadao
世界公园	shijiegongyuan
世纪公园	shijigongyuan
世纪城	shijicheng
世纪大街	shijidajie
世纪大酒店	shijidajiudian
世茂大道	shimaodadao
世达广场	shidaguangchang
丛林	wanshengconglin
东三街	dongsanjie
东丽周边	donglizhoubian
东二营	dongerying
东五路	dongwulu
东五里	dongwuli
东亭	dongting
东关	dongguan
东关南街	dongguannanjie
东关大街	dongguandajie
东关屯	dongguantun
东关街	dongguanjie
东兴路	dongxinglu
东北	dongbei
东北塘	dongbeitang
东北大马路	dongbeidamalu
东北师大	dongbeishida
东北街	dongbeijie
东华	donghua
东单	dongdan
东南	dongnan
东南湖大路	dongnanhudalu
东善桥	dongshanqiao
东嘎	duilongdeqingdongga
东四	dongsi
东四十条	dongsishitiao
东圃	dongpu
东坝	dongba
东城中心	dongchengzhongxin
东城区	dongchengqu
东城天下	dongchengtianxia
东塔	dongta
东塘	dongtang
东外滩	dongwaitan
东大	dongda
东大桥	dongdaqiao
东大直街	rongshi
东大街	dongdajie
东天街	dongtianjie
东太康路	dongtaikanglu
东夷大街	dongyidajie
东孚	dongfu
东屏	dongping
东屯渡	dongtundu
东山区	dongshanqu
东山口	dongshankou
东岗	donggangsjz
东岗东路	donggangdonglu
东岗西路	donggangxilu
东岭南街	donglingnanjie
东岭街	donglingjie
东峡	datongzizhixiandongxia
东工商河路	donggongshanghelu
东平路	dongpinglu
东广场	dongguang
东开发区	dongkaifaqu
东新街	dongxin
东方广场	dongfangguangchang
东方红大桥	dongfanghongdaqiao
东方红广场	dongfanghong
东方路地铁	dongfangluditie
东昌站地铁	dongchangzhanditie
东明中学	dongmingzhongxue
东明路	dongminglu
东明路南段	dongminglunanduan
东晓	dongxiao
东朝阳路	dongchaoyanglu
东木头市	dongmutoushi
东林	donglin
东柳	dongliu
东棘坨	dongjituo
东江新城	dongjiangxincheng
东沟岭	donglinggou
东泉	dongquan
东泰	dongtai
东海街	donghai
东海西路	donghaixilu
东涌	dongyong
东渚	dongzhu
东渡	dongdu
东焦	dongjiao
东环	donghuan
东环路	donghuanlu
东瓜山/赤岭路	dongguashan
东瓦窑	dongwayao
东盛	dongsheng
东盛启城	dongshengqicheng
东盟商务区	dongmengshangwuqu
东直门	dongzhimen
东社	dongshe
东站	dongzhan
东站片	dongzhanpian
东苑	dongyuan
东葛路	donggelu
东蒲洼	dongpuwa
东街	dongjie
东财	dongcai
东赵各庄	dongzhaogezhuang
东软	dongruan
东辛房	dongxinfang
东郊	dongjiao
东部市场	dongbushichang
东部市立医院	dongbushiliyiyuan
东里	dongli
东钱湖	dongqianhu
东门	dongmen
东门外	dongmenwai
东陈岗	dongchengang
东风东	dongfengdong
东风东路	dongfengdonglu
东风大街	dongfeng
东风村	dongfengcun
东风西	dongfengxi
东风路	dongfenglu
东马圈	dongmaquan
东高地	donggaodi
东高村	donggaocun
丝茅冲	simaochong
两汇	lianghui
两河	lianghe
两路	lianglu
两路口	lianglukou
中上虞	zhongshangyu
中专路	zhongzhuanlu
中丘路	zhongqiulu
中东大市场	zhongdongdashichang
中云	zhongyun
中亭街	zhongtingjie
中信石竹	zhongxinshizhuxin
中关村	zhongguancun
中兴	zhongxing
中北	zhongbei
中北路	zhongbeilu
中医学院	zhongyixueyuan
中医附院	zhongyifuyuan
中医院	zhongyiyuan
中华	zhonghua
中华中路	zhonghuazhonglu
中华北路	zhonghuabeilu
中华南大街	zhonghuanandajie
中华南路	zhonghuananlu
中华路	zhonghualu
中华门	zhonghuamen
中南路	zhongnanlu
中原西路	zhongyuanxilu
中和	zhonghe
中堡	zhongbao
中塘	zhongtang
中大	zhongda
中大槐树	zhongdahuaishu
中天路	zhongtianlu
中央商务区	zhongyangshangwuqu
中央大街	zhongyangdajie
中央门	zhongyangmen
中山三路	zhongshansanlu
中山东路	zhongshandonglu
中山亭	zhongshanting
中山八路	zhongshanbalu
中山公园	zhongshangongyuan
中山南街	zhongshannanjie
中山南路	zhongshannanlu
中山大道	zhongshandadao
中山广场	yuanlu
中山西路	zhongshanxilu
中山路	zhongshanlu
中山门	zhongshanmen
中峰	zhongfeng
中州岛	zhongzhoudao
中心区	futianzhongxinqu
中新	zhongxin
中方园	zhongfangyuan
中旺	zhongwang
中曹	zhongcao
中梁	zhongliang
中梁山	jiulongpozhongliangshan
中河	zhonghe
中泽国货	zhongzeguohuo
中洲	zhongzhou
中润华侨城	zhongrunhuaqiaocheng
中涧河	zhongjianhe
中百	zhongbai
中街	zhongjie
中远两湾城	zhongyuanliangwancheng
中铁四局	zhongtiesiju
中长	zhongchang
中韩	zhonghan
中马	zhongma
丰乐	fengle
丰产路	fengchanlu
丰台体育馆	fengtaitiyuguan
丰台路	fengtailu
丰宁片区	fengning
丰州路	fengzhoulu
丰年村	fengniancun
丰庄	fengzhuang
丰庆路	fengqinglu
丰收路	fengshoulu
丰泽商城	fengzeshangcheng
丰泽街道	fengzejiedao
丰润	fengrun1
丰益桥	fengyiqiao
丰盛	fengsheng
丰禾路	fenghelu
丰荣	fengrong
临册路	lincelu
临园口	linyuankou
临夏路	linxialu
临岐	linqi
临平	linping
临平路	linpinglu
临春河路	linchunhelu
临江	linjiang
临沂九中	linyijiuzhong
临沂北站	linyibeizhan
临沂大学	linyidaxue
临沂机场	linyijichang
临河街	linhejie
临河里	linheli
临泉东路	linquandonglu
临洮街	lintaojie
临济	linji
临港新城	lingangxincheng
临湖	linhu
临西九路	linxijiulu
临西十路	linxishilu
临邛	linqiong
丹东	dandong
丹凤街	danfengjie
丹景山	danjingshan
丹水池	danshuichi
丹灶	danzao
丹西	danxi
主山	zhushan
丽春	lichun
丽泽桥	lizeqiao
丽臣路	lichenlu
乃琼	naiqiong
久长	jiuchang
么六桥	meliuqiao
义乌商品城	yiwushangpincheng
义井	yijing
义兴	yixing
义和	yihe
义和路	yihelu
义城	yicheng
义堂	yitang
义洲	yizhou
乌兰察布路	wulanchabulu
乌山路	wushanlu
乌拉泊	wulabo
乌昌路	wuchanglu
乌玛塘	wumatang
乌鲁隆	wululong
乌龙泉	wulongquan
乐从	lecong
乐化	lehua
乐松	anle
乐甲	lejia
乔庄	qiaozhuang
九三路	jiusanlu
九亭	jiuting
九佛	jiufo
九堡	jiupu
九宫庙	jiugongmiao
九尺	jiuchi
九州	jiuzhou
九州大厦	jiuzhoudasha
九庄	jiuzhuang
九棵树	jiukeshu
九水路	jiushuilu
九江	jiujiang
九江镇	jiujiangzhen
九池	jiuchi
九洲大道	jiuzhoudadao
九渡河	jiuduhe
九眼桥	jiuyanqiao
九路市场	jiulushichang
九里堤	jiulidi
九龙坡周边	jiulongpozhoubian
九龙湖	jiulonghu
习岗	xigang
书圣街	shushengjie
书院街	shuyuanjie
书院路	shuyuanlu
乳山口	rushankou
乳山寨	rushanzhai
乳山市区	rushanshiqu
二七北路	erqibeilu
二七南路	erqinanlu
二七广场	erqiguangchang
二七新村	erqixincun
二中	erzhong
二中学区	erzhongxuequ
二仙桥	erxianqiao
二十里堡	ershilipu
二台子	ertaizi
二号桥	erhaoqiao
二圣	ersheng
二工	ergong
二府庄	erfuzhuang
二戈寨	ergezhai
二沙岛	ershadao
二牛所口	erniusuokou
二环东路北段	erhuandonglubeiduan
二环东路南段	erhuandonglunanduan
二环南路	erhuannanlu
二环西路	erhuanxilu
二环路	erhuanlu
二经	erjing
二郎	erlang
二里岗	erligang
二里庄	erlizhuang
二里街	erlijie
二马路	ermalu
于埠	yubu
于家房	yujiafang
于洪区委	yuhongquwei
于洪广场	yuhongguangchang
于洪新城	yuhongxincheng
云亭镇	yuntingzhen
云南路	yunnanlu
云台	yuntai
云合	yunhe
云山	yunshan
云岗	yungang
云岭路	yunlinglu
云峰	yunfeng
云景路	yunjinglu
云纺片区	tuqiao
云谷工业区	yungugongyequ
云集	yunji
互助路立交	huzhululijiao
五一北路	wuyibeilu
五一南路	wuyinanlu
五一商店	wuyishangdian
五一大道	wuyidadao
五一广场	wuyiguangchang
五一路	wuyilu
五七	wuqi
五三	wusan
五中家乐福	wuzhongjialefu
五凌电力	wulingdianli
五凤	wufeng
五四北	wusibei
五四广场	wusiguangchang
五四路	wusilu
五块石	wukuaishi
五堡	wupu
五塘	wutang
五大花园	jinyang
五宝	wubao
五山	wushan
五峰山	wufengshan
五显	wuxian
五桂桥	baohe
五桥	wuqiao
五棵松	wukesong
五泉	wuquan
五泉广场	wuquangguangchang
五津	wujin
五爱市场	wuaishichang
五爱路	wuailu
五百户	wubaihu
五羊新城	wuyangxincheng
五老村	wulaocun
五角场	wujiaochang
五象大道	wuxiangdadao
五象广场	wuxiangguangchang
五道口	wudaokou
五里	wuli
五里亭	wuliting
五里坨	wulituo
五里堆	wulidui
五里堡	wulipu
五里墩	wulidun
五里店	wulidian
五里庙	wulimiao
五里桥	wuliqiao
五里沟	wuligou
五里河	wulihe
五里牌	wulipai
五院	wuyuan
井冈山大道	xujiafang
井口	shapingbajingkou
井岗	jinggang
井岸	jingan
井湾子	jingwanzi
亚明	yaming
亚泰大街	yataidajie
亚美大厦	yameidasha
亚运村	yayuncun
交大	jiaoda
交大路	jiaodalu
交通大学	jiaotongdaxue
交道口	jiaodaokou
亦庄	yizhuang
京东	jingdong
京华城	jinghuacheng
京口路	jingkoulu
京广路	jingguanglu
京溪	jingxi
亭林	tinglin
亭江	tingjiang
亲仁	qinren
亲海园	qinhaiyuan
亲贤	qinxian
亳州路	bozhoulu
人和	renhe
人民	renmin
人民东路	renmingdonglu
人民中路	renminzhonglu
人民公园	wangjiaguai
人民北路	renminbeilu
人民医院	renminyiyuan
人民南	renminnan
人民商场	renminshangchang
人民大学	renmindaxue
人民大街	renmindajie
人民广场	renminguangchang
人民广场东	renminguangchangdong
人民广场西	renminguangchangxi
人民街	renminjie
人民路	renminlu
人民路立交桥	renminlulijiaoqiao
什刹海	shichahai
仁义	renyi
仓前	cangqian
仓埠	cangbu
仓门街	cangmenjie
付家庄	fujiazhuang
仙村	zengchengxiancun
仙林	xianlin
仙海镇	xianhaizhen
仙葫经济开发区	xianhujingjikaifaqu
仙霞岭路	xianxialinglu
仙霞新村	xianxiaxincun
代王	daiwang
仰天湖	yangtianhu
仲夏路	zhongxialu
仲宫	zhonggong
伊春路	yichunlu
伊河路	yihelu
伍仙桥	wuxianqiao
伍家岭	wujialing
伏龙坪	fulongping
休门	xiumen
会展中心	huizhanzhongxin
伦教	lunjiao
伶俐镇	linglizhen
但渡	dandu
低塘	ditang
体育中心	tiyuzhongxin
体育北大街	tiyubeidajie
体育南大街	tiyunandajie
体育场	tiyuchang
体育新城	tiyuxincheng
体育西路	tiyuxilu
体育路	tiyulu
体育馆	tiyuguan
体育馆路	tiyuguanlu
何家村	hejiacun
佘山	sheshan
余家	yujia
余杭塘上	yuhangtangshang
佳农市场	jianongshichang
侏儒	zhuru
侨英	qiaoying
侯台	houtai
侯家塘	tianxinhoujiatang
侯家营	houjiaying
便益门广场	bianyimenguangchang
促进路	cujinlu
俄黄路	ehuanglu
俚岛	lidao
保儿	baoer
保国	baoguo
保工	baogong
保税区	baoshuiqu
信息城	xinxicheng
信息大厦	xinxidaxia
信河街 	xinhejie
l口	biaokou
候家	houjia
候家沟	houjiagou
倚山里	yishanli
偏岩	pianyan
健康街	jiankangjie
健翔桥	jianxiangqiao
傅家坡	fujiapo
儒江	rujiang
儿童公园	ertonggongyuan
儿童医院	ertongyiyuan
元和	yuanhe
元岗	yuangang
元洪城	yuanhongcheng
元疃	yuantuan
元通	yuantong
先进	xianjin
先锋路	xianfenglu
光华	guanghua
光华大道	yongquan
光华街	guanghuajie
光华路	guanghualu
光塔	guangta
光复北路	guangfubeilu
光复路	guangfulu
光复道	guangfudao
光新	guangxin
光明	guangming
光明楼	guangminglou
光明街	guangmingjie
光明路	guangminglu
光社	guangshe
光福	guangfu
光荣	guangrong
光谷	guanggu
光谷大街	guanggudajie
党家镇	dangjiazhen
全安	quanan
全福	quanfu
全福庄	quanfuzhuang
八一	bayi
八一七北路	bayiqibeilu
八一市场	bayishichang
八一桥	bayiqiao
八一路	bayilu
八佰伴	babaiban
八卦岭	bagualing
八卦洲	baguazhou
八大关	badaguan
八大处	badachu
八大峡	badaxia
八大湖	badahu
八宝山	babaoshan
八宝街	babaojie
八廓	bakuo
八斗	badou
八桥	baqiao
八王寺	bawangsi
八经	bajing
八腊庙街	balamiaojie
八街	bajie
八角	bajiao
八达岭	badaling
八达路	badalu
八道湾	badaowan
八里台	nankaibalitai
八里堡	balipu
八里小区	taoqilu
八里庄	balizhuang
八里桥	baliqiao
八门城	bamencheng
八颗	bake
公主坟	gongzhufen
公交新村	gongjiaoxincun
公兴	gongxing
公园	gongyuan
公塘	gongtang
公安厅	gonganting
公平	gongping
公德林	gongdelin
公滨路	xincheng
公路大桥	gongludaqiao
六一中路	liuyizhonglu
六一北路	liuyibeilu
六一南路	liuyinanlu
六家畈	liujiafan
六广	liuchang
六指店	liuzhidian
六榕	liurong
六沟垅	liugoulong
六角亭	liujiaoting
六道湾	liudaowan
六里	liuli
六里山	liulishan
六里村	liulicun
六里桥	liuliqiao
六铺炕	liupukang
兰亭巷	lantingxiang
兰亭路	lantinglu
兰园	lanyuan
兰埔	lanpu
兰山路	lanshanlu
兰陵	lanling
兰陵巷	lanlingxiang
共和新路	gonghexinlu
共富	gongfu
共康	gongkang
共济	gongji
关上	guanshang
关坝	guanba
关山	guanshan
兴关	xingguan
兴凯路	xingkailu
兴华	xinghua
兴华路	xinghualu
兴南街	xingnan
兴城路	xingchenglu
兴学街	xingxuejie
兴宁区政府	xingningquzhengfu
兴寿	xingshou
兴工	xinggong
兴建	xingjian
兴汉门	xinghanmen
兴海路	xinghailu
兴谷	xinggu
兴隆台锡伯族	xinglongtai
兴隆巷	xinglongxiang
兴隆路	xinglonglu
兴顺	xingshun
其奴	qinu
内厝	neicuo
内双楠	neishuangnan
冈上	gangshang
冉义	ranyi
冉家坝	ranjiaba
冉屯路	rantunlu
冉庄	ranzhuang
册山	ceshan
军乐	junle
军博	junbo
军屯	juntun
军庄	yuzhuang
军粮城	junliangcheng
农业东路	nongyedonglu
农业园区	nongyeyuanqu
农业路	nongyelu
农兴	nongxing
农大	nongda
农林下路	nonglinxialu
农科院	nongkeyuan
农讲所	nongjiangsuo
冠县路	guanxianlu
冯三	fengsan
冯家	fengjia
冯家坝	fengjiaba
冯庄	fengzhuang
冲赛康	chongsaikang
冶金	yejin
冷子堡	lengzipu
冼村	tianhexiancun
净月大学城	jingyuedaxuecheng
净月镇	jingyuezhen
净水路	jingshuilu
凌云路	lingyunlu
凌水	lingshui
凌空	lingkong
凌霄路	lingxiaolu
凤仪	fengyi
凤凰台	fenghuangtai
凤凰大街	fenghuangdajie
凤凰山	fenghuangshan
凤凰山路	fenghuangshanlu
凤凰岭	fenghuangling
凤凰西街	fenghuangxijie
凤凰路	fenghuanglu
凤城一路	fengchengyilu
凤城四路	fengchengsilu
凤天路	fengtianlu
凤宾路	fengbinlu
凤岭北	fenglingbei
凤川	fengchuan
凯旋	kaixuan
凯旋路	kaixuan
凯旋门	kaixuanmen
凯瑞园	kairuiyuan
出头岭	chutouling
出江	chujiang
分水	fenshui
切玛	qiema
刘二堡	liuerpu
刘家堡	liujiapu
刘家店	liujiadian
刘家桥	liujiaqiao
刘家窑	liujiayao
刘寨	liuzhaipian
刘长山路	liuchangshanlu
则徐大道	zexudadao
创业大街	chuangyedajie
创业大道	chuangyedadao
创业路	chuangyelu
初家	chujia
初村	chucun
利民开发区	liminkaifaqu
利津路	lijinlu
利港镇	ligangzhen
别山	bieshan
制锦市	zhijinshi
前十大街	qianshidajie
前卫	qianwei
前卫营	qianweiying
前坊	qianfang
前川	qianchuan
前横路	qianhenglu
前洲镇	qianzhouzhen
前海	qianhai
前进大街	qianjindajie
前进街	qianjinjie
前进路	qianjinlu
前门	chongwenqianmen
劝业场	quanyechang
加洲新牌坊	jiazhouxinpaifang
动植物公园	dongzhiwugongyuan
动植物园	dongzhiwuyuan
动物园	dongwuyuan
劲松	jingsong
劳动	laodong
劳动中路	laodongzhonglu
劳动公园	laodonggongyuan
劳动广场	laodongguangchang
劳动西路	laodongxilu
劳动路	laodonglu
勒流	leliu
勤业	qinye
化纤厂路	huaxianchanglu
化龙桥	hualongqiao
北一路	beiyilu
北七家	beiqijia
北三路	beisanlu
北下街	beixiajie
北二路	dugong
北京东路	beijingdonglu
北京街	beijing
北京西路	beijingxilu
北京路	beijinglu
北仓	beicang
北仲路	beizhonglu
北关环岛	beiguanhuandao
北兴	beixing
北古城	beigucheng
北四路	beisilu
北园	beiyuan
北园大街历城段	beiyuandajielichengduan
北园路	beiyuanlu
北坦街	beitanjie
北城区	beichengqu
北塘街	beitang
北外滩	beiwaitan
北大地	beidadi
北大学城	beidaxuecheng
北大清华	beidaqinghua
北大营	beidaying
北大街	beidajie
北大街街道	beidajiejiedao
北大路	beidalu
北太平庄	beitaipingzhuang
北宅	beizhai
北安路	beianlu
北宫	beigong
北小辛庄	beixiaoxinzhuang
北山	beishan
北山门	beishanmen
北岗桥	beigangqiao
北岭	beiling
北工大	beigongda
北市	beishi
北干	beigan
北庄	beizhuang
北房	beifang
北新区	beixinqu
北新桥	beixinqiao
北新泾	beixinjing
北新街	beixinjie
北新道八方	beixindaobafang
北村	beicun
北杜	beidu
北林路	beilinlu
北桥	beiqiao
北正街	beizhengjie
北沙滩	beishatan
北洼路	beiwalu
北海街	beihaijie
北淮淀	beihuaidian
北温泉	beiwenquan
北湖路	beihulu
北	beijiao
北滨路	beibinlu
北环	beihuan
北环商城	shengli
北站	xinbeizhan
北站东路	beizhandonglu
北站西路	beizhanxilu
北站路	beizhanlu
北苑	tongzhoubeiyuan
北荣街	beirongjie
北营	beiying
北蔡	beicai
北行	beixing
北辰周边	beichenzhoubian
北辰财富中心	beichencaifuzhongxin
北道口	beidaokou
北闸口	beizhakou
北院门	beiyuanmen
北陵	beiling
匡山	kuangshan
匡远	kuangyuan
区政府	quzhengfu
区政府片区	quzhengfupianqu2
十三陵	shisanling
十二路	shierlu
十八里店	shibalidian
十六里河	shiliulihe
十四纬路	shisiweilu
十字街	shizijie
十里堡	miyunshilipu
十里岗	shiligang
十里店	shilidian
十里河	shilihe
十里铺	shilipu
十陵	shiling
千佛山	qianfoshan
千山路	qianshanlu
千岛湖	qiandaohu
千峰	qianfeng
千灯	qiandeng
千灯湖	qiandenghu
升州路	shengzhoulu
升平	shengping
午极	wuji
半山	banshan
半淞园路	bansongyuanlu
华东理工	huadongligong
华乐	huale
华乐广场	hualeguangchang
华仙路	huaxianlu
华侨城	huaqiaocheng
华侨路	huaqiaolu
华信路	huaxinlu
华北路	huabeilushk
华南	huananbankuai
华南广场	huananguangchang
华城路	huachenglu
华士镇	huashizhen
华夏路	huaxialu
华大	huada
华威桥	huaweiqiao
华家屯	huajiatun
华山	huashan
华山路	huashanlu
华山镇	huashanzhen
华岩	huayan
华师大	huashida
华庄	huazhuang
华强	huaqiang
华强北	huaqiangbei
华强南	huaqiangnan
华新街	huaxinjie
华明	huaming
华景新城	huajingxincheng
华林	hualin
华林坪	hualinping
华林路	hualinlu
华正	huazheng
华泾	huajing
华洲	huazhou
华海3c电脑城	huahai3cdiannaocheng
华港新村	huagangxincun
华漕	huacao
华苑	huayuan
华苑南	huayuannan
华蓥山	huayingshan
华通	huatong
华阳	huayang
华阳路	huayanglu
华龙路	hualonglu
卓刀泉	zhuodaoquan
卓达	zhuoda
南七里站	nanqilizhan
南中环	nanzhonghuan
南二环路	nanerhuanlu
南京东路	nanjingdonglu
南京街	nanjingjie
南京西路	nanjingxilu
南京路	jinhulu
南关客运站	nanguankeyunzhan
南关岭	nanguanling
南内环	nanneihuan
南华西	nanhuaxi
南口	nankou
南园新村	nanyuanxincun
南坛下埔	nantanxiapu
南坨子	nantuozi
南坪	nanannanping
南城区	nanchengqu
南城车站	nanchengchezhan
南塔	nanta
南外滩	nanwaitan
南大街	nandajie
南天	nantian
南寒	nanhan
南寨	nansai
南屏	nanping
南屏街片区	huguo
南山医院	nanshanyiyuan
南山路	nanshanlu
南山镇	nanshanzhen
南岭	nanling
南岸周边	nananzhoubian
南岸路	nananlu
南川东路	nanchuandonglu
南川西路	nanchuanxilu
南市	hepingnanshi
南广场	nanguang
南庄	nanzhuang
南延线	nanyanxian
南开周边	nankaizhoubian
南彩	nancai
南彭	nanpeng
南新路口	nanxinlukou
南星	nanxing
南晓	nanxiao
南木	nanmu
南村	nancun
南极市场	nanjishichang
南桐	nantong
南桥	nanqiao
南桥寺	nanqiaosi
南江滨路	nanjiangbinlu
南沱	nantuo
南河	nanhe
南河坝	nanheba
南河大桥	nanhedaqiao
南油	nanyou
南泉	nanquan
南洲	nanzhou
南浦	nanpu
南浦路	nanpulu
南海大道北	nanhaidadaobei
南海广场	nanhaiguangchang
南湖北路	nanhubeilu
南湖南路	nanhunanlu
南湖广场	nanhuguangchang
南湖汽车站	nanhuqichezhan
南湖花园	nanhuhuayuan
南湖路	nanhulu
南源	nanyuan
南滨路	nanbinlu
南滩	nantan
南焦	nanjiao
南熏大道	nanxundadao
南直路	nanzhilu
南石头	nanshitou
南码头	nanmatou
南磨房	nanmofang
南礼士路	nanlishilu
南禅寺	nanchansi
南窑片区	nanyaopianqu
南站	nanzhan
南纪门	nanjimen
南纬路	nanweilu
南线	nanxian
南羊	nanyang
南翔	nanxiang
南苑	nanyuan
南苑街	nanyuanjie
南茶坊	nanchafang
南莲路	nanlianlu
南菜园	nancaiyuan
南营门	hepingnanyingmen
南蔡村	nancaicun
南街	nanjie
南辛庄	nanxinzhuang
南邵	nanshao
南郊公园	nanjiaogongyuan
南部新城	nanbuxincheng
南门	nanmen
南门口	nanmenkou
南门路	nanmenlu
南闸镇	nanzhazhen
南阳新村	nanyangxincun
南阳路	nanyanglu
南院门	nanyuanmen
南马路	nanma
南黄	nanhuang
博物馆	bowuguan
卡如	karu
卡子湾	kaziwan
卡孜	kazi
卢沟桥	lugouqiao
卫城	weicheng
卫岗	weigang
卫工	weigong
卫星广场	weixingguangchang
卫星路	weixinglu
卫生路	weishenglu
印斗路	yindoulu
即丘路	jiqiulu
卷洞	juandong
卸甲甸	xiejiadian
厂前	changqian
历山北路	lishanbeilu
历山路	lishanlu
厦港	xiagang
厦禾路	xiahelu
县坝	xianba
县府街	xianfujie
又新	youxin
友协	youxie
友好北路	youhaobeilu
友好南路	youhaonanlu
友好广场	youhaoguangchang
友新	youxin
友爱	youai
友谊大道	qingshanyouyidadao
友谊街口	youyijiekou
友谊路	youyilu
双东坊	shuangdongfang
双井	shuangjing
双凤桥	shuangfengqiao
双口	shuangkou
双塔东西街	shuangtadongxijie
双塘	shuangtang
双墩	shuangdun
双定镇	shuangdingzhen
双山	shuangshan
双岗	shuanggang
双月园路	shuangyueyuanlu
双月路	shuangyuelu
双月门	shuangyuemen
双杭	shuanghang
双柳	shuangliu
双桂路	shuangguilu
双桥子	shuangqiaozi
双桥河	shuangqiaohe
双桥路	shuangqiaolu
双榆树	shuangyushu
双水碾	shuangshuinian
双河口	wanzhoushuanghekou
双港	shuanggang
双环村	shuanghuancun
双碑	shuangbei
双街	shuangjie
双路	shuanglu
双闸	shuangzha
双龙	shuanglong
双龙大道	shuanglongdadao
双龙湖	shuanglonghu
叠山路	dieshanlu
口东	koudong
古北	gubei
古北口	gubeikou
古城台	guchengtai
古城建政区	guchengjianzhengqu
古彭广场	gupengguangchang
古林街	gulin
古柏	gubai
古美罗阳	gumeiluoyang
古荡	gudang
古荣	gurong
古路	gulu
只楚	zhichu
可园	keyuan
台东	taidong
台北路	taibei
台头	taitou
台湾街	taiwanjie
台西	taixi
史各庄	baodishigezhuang
右安门	fengtaiyouanmen
叶茂台	yemaotai
司里街	silijie
司门口	simenkou
合作路	hezuolu
合家福购物街	hejiafugouwujie
合工大	hegongda
合庆	heqing
合江亭	hejiangting
合肥路	hefeilu
吉大	jida
吉崩岗	jibenggang
吉日	jiri
吉林	jilin
吉祥	jixiang
吉祥路	jixianglu
同乐	tongle
同光路	tongguanglu
同和	tonghe
同安路	tonganlu
同德围	tongdewei
同德路	tongdelu
同志街	tongzhijie
同里	tongli
同集南路	tongjinanlu
同集路	tongjilu
后坝	houba
后宰门	houzaimen
后山	houshan
后沙峪	houshayu
后洲	houzhou
后海	houhai
后湖	houhuxiang
后溪	houxi
后盐	houyan
向塘	xiangtang
向工	xianggong
向阳楼	xiangyanglou
向阳街	xiangyang
向阳路	xiangyanglu
吕岭路	lvlinglu
吕田	lvtian
吞巴	tunba
吟月桥	yinyueqiao
含谷	hangu
启工	qigong
启阳路	qiyanglu
吴圩	wuxu
吴家山	wujiashan
吴山	wushan
吴庄花园	wuzhuanghuayuan
吴泾	wujing
吴淞	wusong
吴门桥	wumenqiao
员村	yuancun
员村二横路	yuancunerhenglu
周家嘴路	yangpuzhoujiazuilu
周家坝	zhoujiaba
周家桥	zhoujiaqiao
周家泉	zhoujiaquan
周家渡	zhoujiadu
周市	zhoushi
周庄	zhouzhuang
周庄镇	zhouzhuangzhen
周新庄	zhouxinzhuang
周格庄	zhougezhuang
周水子	zhoushuizi
周浦	zhoupu
周良庄	zhouliangzhuang
周谷堆	zhougudui
周铁镇	zhoutiezhen
周门	zhoumen
呼家楼	hujialou
和义	heyi
和兴路	hexing
和凤	hefeng
和平东路	hepingdonglu
和平公园	hepinggongyuan
和平南	hepingnan
和平周边	hepingzhoubian
和平大街	hepingdajie
和平大道	hepingdadao
和平广场	hepingguangchang
和平村	taihe
和平街	hepingjie
和平西路	hepingxilu
和平路	hepinglu
和平里	hepingli
和平门	hepingmen
和桥镇	heqiaozhen
和泰新城	hetaixincheng
和煦园	hexuyuan
和田	hetian
和田街	hetianjie
和盛	hesheng
和睦	hemu
咸嘉新村	xianjiaxincun
咸嘉湖	xianjiahu
咸水沽	xianshuigu
咸阳北路	xianyangbeilu
哈平路	hapinglu
哈站	hazhan
哈药路	zhengyanghe
哈西	haxi
哈达	hada
哈量	haliang
哲里木路	zhelimulu
唐元	tangyuan
唐口	tangkou
唐嘎	tangga
唐园	tangyuan
唐官屯	tangguantun
唐家口	tangjiakou
唐家墩	tangjiadun
唐家湾	tangjiawan
唐山街	tangshanjie
唐岛湾	tangdaowan
唐延路	tangyanlu
唐昌	tangchang
唐村	tangcun
唐镇	tangzhen
唯亭	weiting
商代遗址	shangdaiyizhi
商务内环	shangwuneihuan
商品街	shangpinjie
商城路	shangchenglu
商鼎路	shangdinglu
啤酒厂	pijiuchang
啤酒城	pijiucheng
啤酒街	pijiujie
喀什东路	kashidonglu
善化路	shanhualu
嘉兴	jiaxing
嘉兴路	jiaxinglu
嘉园	jiayuan
嘉定城区	jiading1
嘉定山	jiadingshan
嘉定路	jiadinglu
嘉定镇	jiadingzhen
嘉禾望岗	jiahewanggang
嘉禾路	jiahelu
嘉莲	jialian
嘉陵道	jialingdao
四中路	sizhonglu
四公里	sigongli
四唯	siwei
四季青	sijiqing
四川北路	sichuanbeilu
四平路	yangpusipinglu
四微	siwei
四惠	sihui
四方坪	sifangping
四方长途站	sifangchangtuzhan
四牌楼	baohegongyuan
四道街	sidaojie
四里村	silicun
回兴	huixing
回龙	huilong
回龙坝	huilongba
回龙湾	huilongwan
回龙观	huilongguan
因民	yinmin
团山	tuanshan
团岛	tuandao
团泊	tuanbo
团结	tuanjie
团结新村	tuanjiexincun
团结湖	tuanjiehu
团结路	tuanjielu
园岭	yuanling
园艺山	yuanyishan
固城	gucheng
固驿	guyi
国兴	guoxing
国基路	guojilu
国奥现代城	guoaoxiandaicheng
国家经济开发区	guojiajingjikaifaqu
国展	guozhan
国展中心	guozhanzhongxin
国货	guohuo
国贸	guomao
国贸中心	guomaozhongxin
国防科大	guofangkeda
国际会展中心	guojihuizhanzhongxin
国际海水浴场	guojihaishuiyuchang
图书馆	tushuguan
土主	tuzhu
土城	tucheng
土桥	tuqiao
土湾	tuwan
土贤庄	tuxianzhuang
土门	tumen
土门墩	tumendun
土顶	tuding
圣水青义	shengshuiqingyi
圣灯	shengdeng
圭塘	guitang
地宝	dibao
地段街	zhaolin
地磅	dibang
地质中学	dizhizhongxue
坂田	bantian
均安	junan
均禾	junhe
坎墩	kandun
坑口	kengkou
坛洛镇	tanluozhen
坝陵桥	balingqiao
坞城	wucheng
坡子街	pozijie
坪地	pingdi
垡头	fatou
埃德蒙顿路	aidemengdunlu
城东湖	chengdonghu
城东版块	chengdongbankuai
城东路	chengdonglu
城乡路	chengxianglu
城北乡	chengbeixiang
城北新区	chengbeixinqu
城北版块	chengbeibankuai
城北街道	chengbeijiedao
城南	chengnan
城南新区	chengnanxinqu
城南版块	chengnanbankuai
城南路	chengnanlu
城子街道	chengzijiedao
城市广场	chengshiguangchang
城桥	chengqiao
城西客运站	chengxikeyunzhan
城西版块	chengxibankuai
城角	chengjiao
城郊	chengjiao
城镇	chengzhen
城隍庙	chenghuangmiao
埠柳	buliu
培元桥	peiyuanqiao
培黎广场	peiliguangchang
堡子	fulingpuzi
堡镇	baozhen
堤北	dibei
堤口路	dikoulu
堰桥街道	yanqiaojiedao
塔吉	taji
塔头	tatou
塔尔	taer
塔山	tashan
塔湾	tawan
塔荣	tarong
塘加	tangjia
塘南	tangnan
塘果	tangguo
塘桥	tangqiao
塘汛	tangxun
塘沽周边	tangguzhoubian
塘沽新村街	tangguxincunjie
增光路	zengguanglu
增福	zengfu
墩子塘	dunzitang
壮锦大道	zhuangjindadao
复兴	fuxing
复兴中路	fuxingzhonglu
复兴公园	fuxinggongyuan
复兴门	fuxingmen
复旦大学	fudandaxue
复洲城	fuzhoucheng
复盛	fusheng
夏官营	xiaguanying
夏庄	xiazhuang
夏村	xiacun
夏港街道	xiagangjiedao
夏湾	xiawan
外双楠	shuangnan
外滩	waitan
外高桥	waigaoqiao
多巴	duoba
多林	duolin
大东关	dadongguan
大东路	dalonglu
大丰堆	dafengdui
大众街	dazhongjie
大佛段	dafoduan
大信	daxin
大光路	daguanglu
大兴乡	daxingxiang
大兴路	daxinglu
大冲	dachong
大划	dahua
大北	dabei
大北涧沽	dabeijiangu
大华	dahua
大南	danan
大南街	dananjie
大南门	dananmen
大发	xinhua
大口屯	dakoutun
大召	dazhao
大同街	datongjie
大周	dazhou
大唐世家	datangshijia
大唐庄	datangzhuang
大商汇	dashanghui
大圩	daxu
大场	dachang
大坡	dapo
大坪	daping
大城山公园	dachengshangongyuan
大塘	datang
大墅	dashu
大外	dawai
大孟庄	damengzhuang
大季家	dajijia
大孤家子	dagujiazi
大孤山	dagushan
大学东路	daxuedonglu
大学南路	daxuenanlu
大学城	daxuecheng
大学西路	daxuexilu
大学路	daxuelu
大宁路	daninglu
大寨	dazhai
大寺	dasi
大尧	dayao
大屯	datun
大山子	dashanzi
大山洞	dashandong
大岗	dagang
大嶝	dadeng
大差市	dachashi
大庆北路	daqingbeilu
大庆南路	daqingnanlu
大张庄	dazhangzhuang
大弯	dawan
大成	dacheng
大方里	dafangli
大明路	daminglu
大智街	dazhi
大有恬园	dayoutianyuan
大望路	xidawanglu
大李家	dalijia
大林	dalin
大柏树	dabaishu
大桥南路	daqiaonanlu
大桥道	daqiaodao
大桥镇	daqiaozhen
大梅沙	dameisha
大椿桥	dachunqiao
大榆树	dayushu
大榭	daxie
大毕庄	dabizhuang
大水泊	dashuibo
大沙	dasha
大沙头	dashatou
大沙田	dashatian
大沥	dalijd
大河路	dahelu
大沽街	dagu
大润发	darunfa
大润发邗江店	darunfahanjiangdian
大湾	dawan
大溪沟	daxigou
大潘镇	dapanzhen
大王古庄	dawangguzhuang
大王家巷	dawangjiaxiang
大王庄	dawangzhuang
大疃	datuan
大白庄	dabaizhuang
大盛	dasheng
大直沽	dazhigu
大石	dashi
大石坝	dashiba
大碱厂	dajianchang
大\	daqi
大福源	dafuyuan
大窑湾	dayaowan
大竹林	dazhulin
大红门	dahongmen
大纺	dafang
大经街	donghua
大经路	dajinglu
大胡同	dahutong
大良	daliang
大芬村	dafencun
大菜市	dacaishi
大营	daying
大营盘	dayingpan
大营门	dayingmen
大行宫	daxinggong
大西街	daxijie
大观园	daguanyuan
大连天地	daliantiandi
大连湾	dalianwan
大连路	dalianlu
大通路	datonglu
大邱庄	daqiuzhuang
大郭	daguo
大钟寺	dazhongsi
大钟庄	dazhongzhuang
大铺	dapu
大院	dayuan
大雁塔	dayanta
大集	daji
大面	damian
大马村	damacun
大马路	damalu
大魏家	daweijia
大黄堡	dahuangpu
天一广场	tianyiguangchang
天伦广场	tianlunguangchang
天佑	tianyou
天元东路	tianyuandonglu
天元帝景	tianyuandijing
天光路	tianguanglu
天化	tianhua
天台山	tiantaishan
天回	tianhui
天园	tianyuan
天地广场	tiandiguangchang
天城	tiancheng
天塔	tianta
天山大街	tianshandajie
天山海世界	tianshanhaishijie
天山路	tianshanlu
天平架	tianpingjia
天府	tianfu
天府广场	xiyuhe
天彭	tianpeng
天心区政府	tianxinquzhengfu
天心周边	tianxinzhoubian
天心阁	tianxinge
天成路	tianchenglu
天拖南	tiantuonan
天星寺	tianxingsi
天星桥	tianxingqiao
天桥东街	tianqiaodongjie
天水	tianshui
天河东路	tianhedonglu
天河公园	tianhegongyuan
天河北	tianhebei
天河南	tianhenan
天河客运站	tianhekeyunzhan
天河路	tianhelu
天津街	tianjinjie
天津路	tianjinlu
天生	beibeiwansheng
天目西路	tianmuxilu
天穆	tianmu
天竺	tianzhu
天苑	tianyuan
天通苑	tiantongyuan
天马	tianma
天马山	tianmashan
天鹅饭店	tianefandian
太乙宫	taiyigong
太乙路	taiyilu
太升路	taishenglu
太华路	taihualu
太华镇	taihuazhen
太原街	taiyuanjie
太古	taigu
太宁路口	taininglukou
太安	taian
太师屯	taishitun
太平南路	taipingnanlu
太平广场	taipingguangchang
太平桥	taiping
太慈桥	taiciqiao
太极	taiji
太榆路	taiyulu
太湖花园	taihuhuayuan
太白南路	taibainanlu
太白小区	taibaixiaoqu
太阳城	taiyangcheng
太阳宫	taiyanggong
太阳岛	taiyangdao
太阳沟	taiyanggou
太龙	tailong
夫子庙	fuzimiao
头桥	touqiao
夹关	jiaguan
奇山	qishan
奉城	fengcheng
奋斗	fendou
奎园	kuiyuan
L山	zhashan
奢岭	sheling
奥体	aoti
奥体中心	aotizhongxin
奥帆基地	aofanjidi
奥林匹克广场	aolinpike
奥运村	aoyuncun
好又多	haoyouduo
如多	ruduo
妙峰山	miaofengshan
姚家	yaojia
姚家园	yaojiayuan
姚寨	yaozhai
姜家	jiangjia
姜戈庄	jianggezhuang
威坪	weiping
威海路	weihailu
威清路	weiqinglu
娄葑	loufeng
娄门	loumen
媒体村	meiticun
子午	ziwu
子牙	ziya
孔家崖	kongjiaya
孔浦	kongpu
孙各庄满族	sungezhuangmanzu
孙坂路	sunbanlu
孙家	sunjia
孙家沟	sunjiagou
孙家疃	sunjiatuan
孙文东路	sunwendonglu
孙村	suncun
孛兰	beilan
孝友路	xiaoyoulu
孝陵卫	xiaolingwei
孟家	mengjia
孟寨	mengzhai
季华路	jihualu
学堂	xuetang
学府	baojian
学府大道	xuefudadao
学府街	xuefu
学院街	xueyuanjie
学院路	xueyuanlu
孺子路	ruzilu
宁中	ningzhong
宁华路	ninghualu
宁园	ningyuan
宁国路	ningguolu
宁夏路	ningxialu
宁波东站	ningbodongzhan
宁海路	ninghailu
宅吉	zhaiji
安东街	andongjie
安亭	anting
安医附院	anyifuyuan
安吉大道	anjidadao
安国街	anjing
安埠	anbu
安宁东路	anningdonglu
安宁南路	anningnanlu
安宁堡	anningpu
安宁庄	anningzhuang
安宁渠	anningqu
安宁西路	anningxilu
安定门	andingmen
安居路	anjulu
安庆路	anqinglu
安德	ande
安德门	andemen
安徽农业大学	anhuinongyedaxue
安徽大学	anhuidaxue
安慧桥	anhuiqiao
安昌桥	anchangqiao
安村	ancun
安泰	antai
安澜	anlan
安盛	ansheng
安西	anxi
安西街	anxijie
安贞	anzhen
安达街	andajie
安镇	anzhen
安靖	anjing
宋家庄	songjiazhuang
宋村	songcun
宋营	songying
宏伟路	dayoufang
宏大路	hongdalu
宏远	hongyuan
宗关	zongguan
宗汉	zonghan
官亭	guanting
官仓	guancang
官南大道	guannandadao
官园	guanyuan
官庄	guanzhuang
官扎营	guanzhaying
官林镇	guanlinzhen
官洲	guanzhou
定埠	dingbu
定慧寺	dinghuisi
定淮门	dinghuaimen
定王台	dingwangtai
定福庄	dingfuzhuang
宜兴埠	yixingbu
宜城街道	yichengjiedao
宜川路	yichuanlu
宝华街	baohuajie
宝塔桥	baotaqiao
宝山路	baoshanlu
宝岗	baogang
宝林	baolin
宝泉路	baoquanlu
宝龙	baolong
宝龙城市广场	baolongchengshiguangchang
宝龙广场	baolongguangchang
实验中学	shiyanzhongxue
实验小学	shiyanxiaoxue
客村	kecun
客车厂	kechechang
客运东站	keyundongzhan
客运总站	keyunzongzhan
宣庆	xuanqing
宣武门	xuanwumen
宦溪	huanxi
家佳源	jiayuanchang
家具城	qilu
家电城	jiadiancheng
容桂	ronggui
宽城街	liaoyuan
宽平大路	kuanping
密云路	miyunlu
密渡桥路	miduqiaolu
富乐大桥	fuledaqiao
富华	fuhua
富士康	fushikang
富宁街	xingqingfuningjie
富强	fuqiang
富春	fuchun
富春江	fuchunjiang
富民路	fuminlu
富湾	fuwan
富锋	fufeng
寨上	zhaishang
寨子	zhaizi
寸滩	cuntan
对湖	duihu
对青山	duiqingshan
寺儿沟	siergou
寺寨	sizhai
寿安	wenjiangshouan
寿春	shouchun
寿泉	shouquan
将军大道	jiangjundadao
将军路	jiangjunlu
小东	xiaodong
小东门	xiaodongmen
小井	xiaojing
小关	xiaoguan
小北	xiaobei
小南	xiaonan
小召前街	xiaozhaoqianjie
小周	xiaozhou
小城子	xiaochengzi
小埠东	xiaobudong
小天竺	xiaotianzhu
小孤山	xiaogushan
小寨坝	xiaozhaiba
小寨路	xiaozhailu
小岛花园	xiaodaohuayuan
小市	xiaoshi
小平岛	xiaopingdao
小庄	xiaozhuang
小庙	xiaomiao
小林子冲	xiaolinzichong
小枧	xiaojian
小桥	xiaoqiao
小梅沙	xiaomeisha
小楼	xiaolou
小汤山	xiaotangshan
小津桥	xiaojinqiao
小海地	xiaohaidi
小淀	xiaodian
小港	xiaogang
小王庄	xiaowangzhuang
小白楼	xiaobailou
小窑湾	xiaoyaowan
小站	xiaozhan
小红门	xiaohongmen
小营	xiaoying
小行	xiaoxing
小街	xiaojie
小西	xiaoxi
小西天	xiaoxitian
小西门	xiaoximen
小观	xiaoguan
小金口	xiaojinkou
小雁塔	xiaoyanta
小鱼洞	xiaoyudong
小龙坎	xiaolongkan
尔王庄	erwangzhuang
尖岭	jianling
尚勤路	shangqinlu
尚志大街	daolishangzhi
尤古庄	youguzhuang
尧化	yaohua
尼玛江热	nimajiangre
展览路	zhanlanlu
展览馆	zhanlangguan
山东头	shandongtou
山东庙	shandongmiao
山东路	shandonglu
山东路家乐福	shandonglujialefu
山北	shanbei
山南	shannan
山大北路	shandabeilu
山大南路	shandananlu
山大路	shandalu
山屏街	shanpingjie
山河	shanhe
山洞	shandong
山潘	shanpan
山窝	shanwo
岔路口	chalukou
岔路街	chalujie
岗厦	gangsha
岗店	gangdian
岗集	gangji
岗顶	gangding
岭南	lingnan
岭南大道	lingnandadao
岳各庄	yuegezhuang
岳寨	yuezhai
岳峰	yuefeng
岳林	yuelin
岳阳	yueyang
岳阳街	yueyangjie
岳麓周边	yueluzhoubian
岳麓山	yuelushan
岳龙	yuelong
峡口	xiakou
峪口	yukou
崂山区政府	laoshanquzhengfu
崇兴	chongxing
崇华路	chonghualu
崇安寺街道	chongansijiedao
崇山	chongshan
崇平	chongping
崇文门	chongwenmen
崇明新城	chongmingxincheng
崔黄口	cuihuangkou
崖头	yatou
崖子	yazi
崖西	yaxi
崮云湖	guyunhu
崮山	gushan
嵩山北路	gaoshanbeilu
嵩山路	songshanlu
嵩屿码头	songyumatou
嵩阳	songyang
川师	chuanshi
川沙	chuansha
巢湖路	chaohulu
工业北路	gongyebeilu
工业南路	gongyenanlu
工业大学	gongyedaxue
工业大道	gongyedadao
工业大道中	gongyedadaozhong
工业大道北	gongyedadaobei
工业大道南	gongyedadaonan
工业路	gongyelu
工人文化宫	wenhua
工人新村北村	gongrenxincunbeicun
工人新村南村	gongrenxincunnancun
工人村	gongrencun
工体	gongti
工农大路	gongnongdalu
工农村	gongnongcunjie
工农路	gongnonglu
工卡	gongka
工学院	gongxueyuan
工电路	gongdianlu
工程街	gongcheng
左安门	zuoanmen
左家垅	zhuojialong
左家塘	zuojiatang
左家庄	zuojiazhuang
左岭	zuoling
巨轮	julun
巴城	bacheng
巴燕	bayan
巴福	bafu
巴黎春天	balichuntian
市三医院	shisanyiyuan
市中区	shizhongqu
市中医院	shizhongyiyuan
市中心	shizhongxin
市九龙	shijiulong
市华联	shihualian
市场	shichang
市场街	shichangjie
市府广场	xianqiao
市府路	shifulu
市政府	shizhengfu
市政府小区	shizhengfuxiaoqu
市政府片区	shizhengfupianqu
市桥	shiqiao
市火车站	shihuochezhan
市西路	shixilu
布吉	buji
布吉关	bujiguan
布心	buxin
师范街	shifanjie
师范路	shifanlu
希尔景园	xierjingyuan
希望广场	xiwangguangchang
帕古	pagu
帝湖	dihu
席王	xiwang
帮洲街	bangzhoujie
常州道	changzhoudao
常府街	changfujie
常营	changying
常青	changqing
常青花园	changqinghuayuan
幕府山	mufushan
平凉路	pinglianglu
平安公园	pingangongyuan
平安北大街	pinganbeidajie
平安南大街	pingannandajie
平安路	pinganlu
平房镇	pingfangzhen
平政	pingzheng
平新	pingxin
平望	pingwang
平江新城	pingjiangxincheng
平治街	pingzhijie
平洲	pingzhou
平海路	pinghailu
平溪	pingxi
平谷镇	pingguzhen
平阳街	pingyangjie
平阳路	pingyanglu
并州东西街	bingzhoudongxijie
并州北路	bingzhoubeilu
并州南路	bingzhounanlu
幸福	xingfu
幸福e家	xingfuejia
幸福街	xingfujie
幸福路	xingfulu
幽兰	youlan
广中路	guangzhonglu
广兴	guangxing
广卫	guangwei
广厦新村	guangshaxincun
广园东	guangyuandongzc
广园路	guangyuanlu
广场南路	guangchangnanlu
广埠屯	guangbutun
广安	guangan
广安门	guanganmen
广宜街	zhujianlu
广州大道中	guangzhoudadaozhong
广州大道北	guangzhoudadaobei
广州大道南	guangzhoudadaonan
广州路	guangzhoulu
广开街	guangkai
广武门	guangwumen
广济桥	guangjiqiao
广济街	guangjijie
广润门	guangrunmen
广渠门	guangqumen
广瑞路街道	guangruilujiedao
广电中心	guangdianzhongxin
广电大厦	guangdiandasha
广益街道	guangyijiedao
广福	guangfu
广花	guanghua
广阳	guangyang
庄墓	zhuangmu
庄市	zhenhaizhuangshi
庄桥	zhuangqiao
庄行	zhuanghang
庆丰街	qingfengjie
庐山南大道	lushannandadao
库充	kuchong
应天西路	yingtianxilu
店埠	dianbu
庙前	miaoqian
庙后街	miaohoujie
庙城	miaocheng
庙岭	miaoling
庙行	miaohang
府东府西	fudongfuxi
府前巷	fuqianxiang
府前街	fuqianjie
府南新区	funan
府后街	fuhoujie
府城	fucheng
府青路	fuqinglu
庞各庄	panggezhuang
康健	kangjian
康复路	kangfulu
康安路	kangan
康平街	kangpingjie
康庄	kangzhuang
康桥	kangqiao
康王路	kangwanglu
廉庄	lianzhuang
廖家	liaojia
延吉路	yanjilu
延安	yanan
延安三路	yanansanlu
延安中路	yananzhonglu
延安大路	yanandalu
延安路	yananlu
延长路	yanchanglu
延陵东路	yanlingdonglu
延陵西路	yanlingxilu
建中街	jianzhonglu
建兰路	jianlanlu
建北	jianbei
建国公园	jianguo
建国街	jianguojie
建国路	jianguolu
建国门	jianguomen
建外大街	jianwaidajie
建宁路	jianninglu
建安	jianan
建工学院	jiangongxueyuan
建康路	jiankanglu
建政	jianzheng
建政街道	jianzhengjiedao
建新路	jianxinlu
建昌道	jianchangdao
建明	jianming
建桥	jianqiao
建港路	jianganglu
建筑新村	jianzhuxincun
建胜	jiansheng
建设	jianshe
建设七路	jiansheqilu
建设二路	jiansheerlu
建设北大街	jianshebeidajie
建设北路	jianshebeilu
建设南大街	jianshenandajie
建设南路	jianshenanlu
建设大路	jianshedalu
建设大道	jianshedadao
建设广场	jiansheguangchang
建设街	jianshe
建设路	jianshelu
开元	kaiyuan
开元场	kaiyuanchang
开元路	kaiyuanlu
开发东区	kaifadongqu
开发区周边	kaifaquzhoubian
开发西区	kaifaxiqu
开平路	kaipinglu
开拓路	kaituolu
开源路	kaiyuanlu
开福周边	kaifuzhoubian
开福寺	kaifusi
开运街	kaiyunjie
开阳路	kaiyanglu
引镇	yinzhen
弘海	honghai
张公	zhanggong
张公岭	zhanggongling
张公桥	zhanggongqiao
张关	zhangguan
张前路	zhangqianlu
张官营	zhangguanying
张家产	zhangjiachan
张家堡	zhangjiabao
张家村	zhangjiacun
张家湾	zhangjiawan
张家窝	zhangjiawo
张庄路	zhangzhuanglu
张庙	zhangmiao
张强	zhangqiang
张掖路	zhangyelu
张村	zhangcun
张槎	zhangcha
张江	zhangjiang
张浦	zhangpu
张渚镇	zhangzhuzhen
张贵庄	zhangguizhuang
弹子	danzi
弹子石	danzishi
强嘎	qiangga
弼塘	bitang
当曲卡	dangquka
彩宇大街	caiyudajie
彩田村	caitiancun
彩虹	caihong
彩虹路	caihonglu
彩香	caixiang
彭后	penghou
彭城广场	pengchengguangchang
彭埠	pengbu
彭家桥	pengjiaqiao
彭岗	penggang
彭浦	pengpu
彭镇	pengzhen
影视城	yingshicheng
径河	jinghe
徐东	xudong
徐官屯	xuguantun
徐家	xujia
徐家棚	xujiapeng
徐家汇	xujiahui
徐家湾	xujiawan
徐寨	xuzhai
徐州路	xuzhoulu
徐泾	xujing
徐舍镇	xushezhen
徐霞客镇	xuxiakezhen
得胜	lvshunkoudesheng
御临	yulin
御营坝	yuyingba
御道街	yudaojie
德化街	dehuajie
德政园	dezhengyuan
德民路	deminlu
德源	deyuan
德胜	desheng
德胜门	deshengmen
德雅村	deyacun
德雅路	deyalu
德雅路口	deyalukou
心圩	xinxu
志华商城	zhihuashangcheng
忠诚街	zhongchengjie
怀北	huaibei
怒江北街	nujiang
怡乐路	yilelu
总寨	zongzhai
恒合土家族	henghetujiazu
悦来	yuelai
惜福	xifu
惠南	huinan
惠工	huigong
惠新里	huixinli
慈城	cicheng
慈惠墩	cihuidun
成丰桥	chengfengqiao
成仁路	chengrenlu
成佳	chengjia
成寿寺	chengshousi
成山	chengshan
成才路	chengcailu
成渝立交	chengyulijiao
成龙路	chenglonglu
房山城关	fangshanchengguan
扎佐	zhazuo
扎基	zhaji
扎西岗	zhaxigang
扎雪	zhaxue
打浦桥	dapuqiao
扬名街道	yangmingjiedao
扬子江路	yangzijianglu
扬子洲	yangzizhou
扬州大学城	yangzhoudaxuecheng
扬州汽车站	yangzhouqichezhan
承德广场	donglai
抚松路	fusonglu
抚河	fuhe
抚琴	fuqin
抚顺	fushun
拉康	lakang
拉木	lamu
拓东	tuodong
招商大厦	zhaoshangdasha
招宝山	zhaobaoshan
招贤	zhaoxian
拥政	yongzheng
拦隆口	lanlongkou
拱北	gongbei
拱宸桥	gongchenqiao
拱星墩	gongxingdun
挂甲寺	guajiasi
振兴街	zhenxingjie
振华路	zhenhualu
振头	zhentou
挹江门	yijiangmen
排尾路	paiweilu
接龙	jielong
控江路	kongjianglu
提篮桥	tilanqiao
撮镇	cuozhen
攸攸板	youyouban
改布	gaibu
政务中心	zhengwuzhongxin
政府广场	zhengfuguangchang
敖平	aoping
教化	jiaohua
敦仁	dunren
敦化坊	dunhuafang
敦化路	dunhualu
敦煌路	dunhuanglu
数码广场	shumaguangchang
文一路	wenyilu
文三路	wensanlu
文二路	wenerlu
文体西路	wentixilu
文兰	wenlan
文冲	wenchong
文化东路	wenhuadonglu
文化南路	wenhuananlu
文化宫	wenhuagong
文化宫路	wenhuagonglu
文化广场	wenhuaguangchang
文化街	wenhuajie
文化西路	wenhuaxilu
文化路	wenhualu
文华园	wenhuayuan
文城区	wencheng
文家	wenjia
文庙	wenmiao
文政	wenzheng
文教	wenjiao
文新	wenxin
文昌	wenchang
文昌街	wenchangjie
文昌街道	wenchangjiedao
文昌路	wenchanglu
文昌门	wenchangmen
文昌阁	wenchangge
文星	wenxing
文景路	wenjinglu
文港	wengang
文灶	wenzao
文登营	wendengying
文艺路	wenyilu
文锦	wenjin
文锦渡	wenjindu
文靖路	wenjinglu
斑竹园	banzhuyuan
斜口	xiekou
斜土路	xietulu
斜源	xieyuan
斥山区	chishanqu
斯大林路	sidalinlu
新东	xindong
新东区	xindongqu
新中心区	xinzhongxinqu
新中路立交桥	xinzhonglulijiaoqiao
新仓	xincang
新伟	xinwei
新兴广场	xinxingguangchang
新兴街	xinxing
新华公园	xinhuagongyuan
新华北路	xinhuabeilu
新华医院	xinhuayiyuan
新华南路	xinhuananlu
新华大街	xinhuadajie
新华桥	xinhuaqiao
新华街	xinhuajie
新华西路	xinhuaxilu
新华路	xinhualu
新华路南	xinhualunan
新南门	duyuanjie
新发	xinfa
新发地	xinfadi
新和路	xinhelu
新国展	xinguozhan
新圩	xinxu
新场	xinchang
新城东街	xinchengdongjie
新城区政府	xinchengquzhengfu
新城子	xinchengzi
新城街道	xinchengjiedao
新塘	zengchengxintang
新大桥	xindaqiao
新天地	xintiande
新妙	xinmiao
新安江	xinanjiang
新安街道	xinquxinanjiedao
新安西路	xinanxilu
新安路	xinanlu
新客站	xinkezhan
新宫	xingong
新山村	xinshancun
新市府	xinshifu
新广场	xinguangchang
新庄	xinzhuang
新庄街道	xinzhuangjiedao
新店	xindian
新建街	xinjianjie
新建镇	xinjianzhen
新开口	xinkaikou
新开河	xinkaihe
新开路	xinkailu
新开铺	xinkaipu
新星小区	xinxingxiaoqu
新春	xinchun
新村	xincun
新村街	xincun
新柳	xinliu
新柳路	xinliulu
新桥	xinqiao
新桥镇	xinqiaozhen
新民场	xinminchang
新民屯	xinmintun
新民广场	xinminguangchang
新民路	xinminlu
新江	xinjiang
新江湾城	xinjiangwancheng
新汽车站	xinqichezhan
新沟	xingou
新沟桥	xingouqiao
新河街	xinhe
新添寨	xintianzhai
新港	xingang
新港西	xingangxi
新溉路	xingailu
新疆	xinjiang
新疆街	xinjiangjie
新石	xinshi
新矸	xingan
新\	xinqi
新立	xinli
新竹	xinzhu
新繁	xinfan
新花	qianjiangxinhua
新螺蛳湾	xinluosiwan
新街口	xinjiekou
新街街道	xinjiejiedao
新起屯	xinqitun
新迎片区	xinyingpianqu
新镇	xinzhen
新闸路	xinzhalu
新闻大厦	xinwendasha
新阳	xinyang
新阳工业区	xinyanggongyequ
新阳路	anhe
新香洲	xinxiangzhou
新鸿路	xinhonglu
方中圆商业街	fangzhongyuanshangyejie
方兴	fangxing
方家屯	fangjiatun
方家庄	fangjiazhuang
方家栏	fangjialan
方庄	fangzhuang
方庙	fangmiao
方新村	fangxincun
方村	fangcun
方松	fangsong
施古	shigu
施家梁	shijialiang
旁多	pangduo
旅游路历下段	lvyoululixiaduan
旅游路高新段	lvyoulugaoxinduan
旅顺北路	lvshunbeilu
旅顺南路	lvshunnanlu
旅顺开发区	lvshunkaifaqu
无影山	wuyingshan
无影山东路	wuyingshandonglu
无影山中路	wuyingshanzhonglu
无影山北路	wuyingshanbeilu
无影山西路	wuyingshanxilu
无影山路	wuyingshanlu
无瑕	wuxia
日新	rixin
日湖公园	rihugongyuan
旧区	jiuqu
旧县	jiuxian
旧大桥	jiudaqiao
旧宫	jiugong
旧州	jiuzhou
旧街	jiujie
早化	zaohua
早春园	zaochunyuan
旱西关	hanxiguan
旺庄街道	xinquwangzhuangjiedao
旺座现代城	wangzuoxiandaicheng
昆仑	kunlun
昆仑商城	kunlunshangcheng
昆山路	kunshan
昆明机场	kunmingjichang
昆明街	kunming
昆明路	kunminglu
昆阳	kunyang
昌东	changdong
昌华	changhua
昌国路南段	changguolunanduan
昌岗	changgang
昌平县城	changpingxiancheng
明光路	mingguanglu
明城	mingcheng
明家	mingjia
明廉	minglian
明德门	mingdemen
明月	mingyue
明楼	minglou
明水路	mingshuilu
明湖北路	minghubeilu
明湖西路	minghuxilu
明湖路	minghulu
明珠	mingzhu
明秀路	mingxiulu
明阳路	mingyanglu
易家墩	qiaokouyouyidadao
昙华寺片区	tanhuasipianqu
星光大道	xingguangdadao
星桥	xingqiao
星海公园	xinghaigongyuan
星海广场	xinghaiguangchang
星海湾	xinghaiwan
星火	xinghuo
春光街	chunguangjie
春光路	chunguanglu
春华街	chunhua
春华路	chunhualu
春城大街	chuncheng
春堆	chundui
春晖路	dadukouchunhuilu
春柳	chunliu
春柳河	chunliuhe
春江	chunjiang
春熙路	chunxilu
春申	chunshen
春草路	chuncaolu
晋原	jinyuan
晋城	jincheng
晋祠	jinci
晋陵北路	jinlingbeilu
晏家	yanjia
晏家坪	yanjiaping
晓庄	xiaozhuang
晓港	xiaogang
普东	pudong
普兴	puxing
普吉	puji
普子	wanzhoupuzi
普庆路	puqinglu
普明	puming
普松	pusong
普澜	pulan
普阳街	puyang
普陀路	putuolu
景山	jingshan
景山小区	jingshanxiaoqu
景星	jingxing
景湖花园	jinghuhuayuan
景田	jingtian
景芳	jingfang
景阳	jingyang
景阳广场	jingyangguangchang
晴川	qingchuan
晶桥	jingqiao
曙光中路	shuguangzhonglu
曙光路	shuguang
曙光路口	shuguanglukou
曲甫	qufu
曲阳路	quyanglu
更合	genghe
更楼	genglou
曹子里	caozili
曹家渡	caojiadu
曹庵	caoan
曹张新村	caozhangxincun
曹杨新村	caoyangxincun
曹路	caolu
曾家	cengjia
月坛	yuetan
月城镇	yuechengzhen
月川路	yuechuanlu
月浦	yuepu
月牙河	yueyahe
月牙湖	yueyahu
月苑	yueyuan
服装城	fuzhuangcheng
朔方路	shuofanglu
朗霞	langxia
望京	wangjing
望亭	wangting
望园路	wangyuanlu
望城坡	wangchengpo
望岳	wangyue
望州岭	wangzhouling
望春	wangchun
望月湖	wangyuehu
望江路	wangjianglu
望海楼	wanghailou
望湖城	wanghucheng
望远	wangyuan
望麓园	wangluyuan
望龙门	wanglongmen
朝外	chaowai
朝天宫	chaotiangong
朝天门	chaotianmen
朝安	chaoan
朝晖	zhaohui
朝阳公园	chaoyanggongyuan
朝阳洲	chaoyangzhou
朝阳湖	chaoyanghu
朝阳街	chaoyangjie
朝阳路	chaoyanglu
朝阳门	chaoyangmen
朝青板块	chaoqingbankuai
木材	mucai
木樨园	muxiyuan
木樨地	muxidi
木洞	mudong
木渎	mudu
木耳	muer
未来路	weilailu
朱加	zhujia
朱家房	zhujiafang
朱家角	zhujiajiao
朱巷	zhuxiang
朱昌	zhuchang
朱村	zhucun
朱泾	zhujing
朱雀大街	zhuquedajie
机场	jichang
机场西路	jichangxilu
机场路	jichanglu
机床二厂路	jichuangerchanglu
机投镇	jitouqiao
机研所	jiyansuo
杆石桥	ganshiqiao
杉岭	shanling
李七庄	liqizhuang
李俊	lijun
李园	liyuan
李子坝	liziba
李家	lijia
李家墩	lijiadun
李家山	lijiashan
李家沱	lijiatuo
李山东路	lishandonglu
李店	lidian
李村	licun
李村公园	licungongyuan
李桥	liqiao
李河	lihe
李渡	lidu
李集	liji
杏东路	xingdonglu
杏北路	xingbeilu
杏南路	xingnanlu
杏坛	xingtan
杏林	xinglin
杏花村	suixilu
杏西路	xingxilu
杜北	dubei
杜岭	duling
来广营	laiguangying
杨东	yangdong
杨公	yanggong
杨公桥	yanggongqiao
杨和	yanghe
杨园	yangyuan
杨埠寨	yangbuzhai
杨士	yangshi
杨士岗	yangshigang
杨宋	yangsong
杨家坪	yangjiaping
杨家山	yangjiashan
杨家峪	yangjiayu
杨家村	yangjiacun
杨家泊	yangjiabo
杨家滩	yangjiatan
杨家群	yangjiaqun
杨巷镇	yangxiangzhen
杨庄	yangzhuang
杨庙	yangmiao
杨成庄	yangchengzhuang
杨村	yangcun
杨柳	yangliu
杨柳青	yangliuqing
杨树房	yangshufang
杨桥路	yangqiaolu
杨汊湖	yangchahu
杨津庄	yangjinzhuang
杨浦公园	yangpugongyuan
杨浦大桥	yangpudaqiao
杨箕村	yangqicun
杨行	yanghang
杨镇	yangzhen
杭州路	hangzhoulu
杭州道	hangzhoudao
松北	songbei1
松山小区	songshanxiaoqu
松岗	songgang
松岭路	songlinglu
松峪里	songyuli
松昌	songchang
松桂园	songguiyuan
松江大学城	songjiangdaxuecheng
松江工业区	songjianggongyequ
松江新城	songjiangxincheng
松江科技园	songjiangkejiyuan
松江老城	songjianglaocheng
松洲	songzhou
松浦	songpu
松湖	songhu
松陵	songling
松霞路	songxialu
板仓	bancang
板桥	banqiao
林亭口	lintingkou
林和	linhe
林家崖	linjiaya
林山寨	linshanzhai
林岗	lingang
果园	guoyuan
果园新村	guoyuanxincun
果戈里	guogeli
枣园	zaoyuan
枫叶路	fengyelu
枫林路	fenglinlu
枫树岭	fengshuling
枫桥	fengqiao
枫泾	fengjing
架桥	jiaqiao
柏家沟	baijiagou
柏庄	baizhuang
柏林	bolin
柏林四季	bolinsiji
柏树林	baishulin
柏泉	baiquan
柑子园	ganziyuan
柘塘	zhetang
柘林	zhelin
柠溪	ningxi
柱山	zhushan
柳埠镇	liubuzhen
柳巷	liuxiang
柳影路	liuying
柳梧	liuwu
柳沙片区	liushapianqu
柳花泊	liuhuabo
柳芳	liufang
柳荫	liuyin
柳街	liujie
柳青路	liuqinglu
柴村	chaicun
柴桥	chaiqiao
柿园	shiyuan
栅山	shanshan
标山路	biaoshanlu
树勋街	shuxunjie
树木岭	shumuling
格林小镇	gelinxiaozhen
格达	geda
桂庙路口	guimiaolukou
桂林街	guilin
桂林路	guilin
桂溪	guixi
桂花	guihua
桂花公园	guihuagongyuan
桂花坪	guihuaping
桂花岗	guihuagang
桂花村	guihuacun
桂花路口	guihualukou
桂芳园	guifangyuan
桃仙	taoxian
桃园	taoyuan
桃园街	taoyuan
桃园路	taoyuanlu
桃浦	taopu
桃源居	taoyuanju
桃源村	taoyuancun
桃源街	taoyuan
桃花	taohua
桃花坞	taohuawu
桃苑	taoyuan
桐君	tongjun
桐柏路	tongbailu
桐梓坡	tongzipo
桐梓坡路	tongxinpolu
桐梓林	tongzilin
桑园	sangyuan
桑梓	sangzi
桑珠林	sangzhulin
桔园小区	juyuanxiaoqu
桔子洲	juzizhou
桠溪	yaxi
桤泉	qiquan
桥东区政府	qiaodongquzhengfu
桥中	qiaozhong
桥北	qiaobei
桥华世纪村	qiaohuashijicun
桥南	qiaonan
桥南片区	qiaonanpianqu
桥头胡	qiaotouhu
桥头集	qiaotouji
桥梓	qiaoxin
梁头	liangtou
梁家巷	liangjiaxiang
梅厂	meichang
梅园	meiyuan
梅墟	meixu
梅山	meishan
梅岭	meiling
梅庄	meizhuang
梅村镇	xinqumeicunzhen
梅林	meilin
梅林关口	meilinguankou
梅花园	meihuayuan
梅花村	meihuacun
梅陇	meilong
梓园路	ziyuanlu
梓园路口	ziyuanlukou
梓桐	zitong
梦泽园	mengzeyuan
梧村	wucun
梨园	liyuan
梨园城铁	liyuanchengtie
梯面	timian
棉纺路	mianfanglu
棕树营	zongshuying
棘洪滩	jihongtan
棠下	tangxia
棠景	tangjing
植物园	zhiwuyuan
椒房	jiaofang
椒金山	jiaojinshan
榄核	lanhe
榆林	yulin
槐中路	huaizhonglu
槐北	huaibei
槐安路	huaianluqx
槐底	huaidi
槐西	huaixi
模式口	moshikou
横塘	hengtang
横岗	henggang
横店	hengdian
横扇	hengshan
横村	hengcun
横沙岛	hengshadao
横泾	hengjing
横涧	hengjian
横琴	hengqin
樱园	yingyuan
樱驼花园	yingtuohuayuan
樵舍	qiaoshe
次渠	ciqu
欧家坝	oujiaba
歇马	xiema
歌乐山	shapingbageleshan
止马营	zhimaying
正兴	zhengxing
正果	zhengguo
正阳街	zhengyang
正阳路	zhengyanglu
步行街	buxingjie
武东	wudong
武侯祠大街	wuhoucidajie
武夷花园	wuyihuayuan
武宁路	wuninglu
武屯	wutun
武昌火车站	wuchanghuochezhan
武昌街	wuchangjie
武林	wulin
武泰闸	wutaizha
武胜路	wushenglu
武胜驿	wushengyi
武阳	wuyang
段塘	duantang
段家滩	duanjiatan
段庄广场	duanzhuangguangchang
段店	duandian
段店北路	duandianbeilu
殿前	dianqian
母亲广场	muqinguangchang
毓璜顶	yuhuangding
毫沁营	haoqinying
民丰里	minfengli
民主	hepingminzhu
民主东街	minzhudongjie
民主广场	minzhuguangchang
民康路	minkang
民德路	mindelu
民意	minyi
民族	minzu
民族广场	minzuguangchang
民治	minzhi
民生	minsheng
民生路	minshenglu
民航路	minhanglu
水上公园	shuishanggongyuan
水佐岗	shuizuogang
水口	shuikou
水土	shuitu
水塔	shuita
水屯北路	shuitunbeilu
水屯路	shuitunlu
水市	shuishi
水师营	shuishiying
水库	shuiku
水心	shuixin
水果湖	shuiguohu
水清沟	shuiqinggou
水湖	shuihu
水田	shuitian
水田路	shuitianlu
水碓子	shuiduizi
水碾河	shuijingfang
水荫路	shuiyinlu
水西关	shuixiguan
水西沟	shuixigou
水西门	shuiximen
水贝	shuibei
水部	shuibu
水集	shuiji
水风井	shuifengjing
永兴镇	yongxingzhen
永叔路	yongshulu
永商	yongshang
永安路	yonganlu
永安里	yonganli
永定路	yongdinglu
永定门	yongdingmen
永平路	yongpinglu
永松路	yongsonglu
永清路	yongqinglu
永盛	yongsheng
永盛路	yongshenglu
永盛门	yongshengmen
永阳	yongyang
汀溪	tingxi
汇通路	huitonglu
汉中	hanzhong
汉中门	hanzhongmen
汉兴	hanxing
汉正	hanzheng
汉水桥	hanshuiqiao
汉水路	hanshuilu
汉渝路	hanyulu
汊沽港	chagugang
汝河西路	ruhexilu
汝河路	ruhelu
江东科技园区	jiangdongkejiyuanqu
江东花园	jiangdonghuayuan
江东门	jiangdongmen
江北周边	jiangbeizhoubian
江北城	jiangbeicheng
江南中	jiangnanzhong
江南大道中	jiangnandadaozhong
江南大道南	jiangnandadaonan
江南西	jiangnanxi
江厦	jiangxia
江埔	jiangpu
江多	jiangduo
江大南路	jiangdananlu
江头	jiangtou
江宁路	jiangninglu
江山路	jiangshanlu
江川路	jiangchuanlu
江心洲	jiangxinzhou
江桥	jiangqiao
江汉二桥	jianghanerqiao
江汉路	jianghanlu
江泉酒店	jiangquanjiudian
江浦	jiangpu
江海街道	jianghaijiedao
江湾	jiangwan
江源	jiangyuan
江溪街道	xinqujiangxijiedao
江滨东大道	jiangbindongdadao
江滨中路	jiangbinzhonglu
江滨路	jiangbinlu
江热夏	jiangrexia
江燕路	jiangyanlu
江苏路	jiangsulu
江苏路地铁	jiangsuluditie
江西	jiangxi
江西路	jiangxilu
江都路	jiangdoulu
江阳工业园	jiangyanggongyeyuan
江高	jianggao
汤丹	tangdan
汤头	shangtou
汤山	tangshan
汤峪	tangyu
汤庄	shangzhuang
汤池	tangchi
汤河	shanghe
汤河口	tanghekou
汪疃	wangtuan
汪集	wangji
汶水路	wenshuilu
汽博中心	qibozhongxin
汽贸城	qimaocheng
汽车东站	qichedongzhan
汽车南站	qichenanzhan
汽车厂区	qichechangqu
汽车站	qichezhan
汽车西站	qichexizhan
汾口	fenkou
汾江南路	fenjiangnanlu
汾湖	fenhu
沂州路	yizhoulu
沂河路	yihelu
沂蒙七路	yimengqilu
沂蒙三路	yimengsanlu
沂蒙二路	yimengerlu
沂蒙五路	yimengwulu
沂蒙八路	yimengbalu
沂蒙四路	yimengsilu
沂蒙大楼	yimengdalou
沂蒙路	yimenglu
沃尔玛	woerma
沈家坝	chenjiaba
沈牌子	shenpaizi
沈辽路	yuhongshenliaolu
沙东	shadong
沙井	shajing
沙井大道	shajingdadao
沙井驿	shajingyi
沙冲	shachong
沙口路	ruidalushakoulu
沙园	shayuan
沙坝	shaba
沙坪	shaping
沙坪坝周边	shapingbazhoubian
沙太北	shataibei
沙太南	shatainan
沙头	shatou
沙头角	shatoujiao
沙子口	shazikou
沙尾	shawei
沙岭	shaling
沙庄	shazhuang
沙正街	shazhengjie
沙河源	shaheyuan
沙河镇	shahezhen
沙洲	shazhou
沙渠	shaqu
沙滨路	shabinlu
沙滩	shatan
沙门	shamen
沙面	shamian
沣惠南路	fenghuinanlu
沥	lijiao
沧口体育场	cangkoutiyuchang
沧林路	canglinlu
沧浪新城	canglangxincheng
沧湖北路	canghubeilu
沧虹路	canghonglu
河东周边	hedongzhoubian
河北周边	hebeizhoubian
河北屯	hebeitun
河南岸	henanan
河南庄	henanzhuang
河埒	helie
河套	hetao
河松	hesong
河桥	heqiao
河滨	hebin
河西务	hexiwu
河西周边	hexizhoubian
河西路	hexilu
河马石	hemashi
油榨街	youzhajie
沿东	yandong
沿庄	yanzhuang
沿江	yanjiang
沿海经济开发区	yanhaijingjikaifaqu
泉园	quanyuan
泉城路	quanchenglu
泉水	quanshui
泉河	quanhe
泉秀	quanxiu
泊于	boyu
法华寺	fahuasi
泗塘	sitang
泗村店	sicundian
泗泾	sijing
泡崖	paoya
波航	bohang
泥城	nicheng
泥岗	nigang
泰华	taihua
泰华街	taihuajie
泰山路	taishanlu
泰来街	nanhutailaijie
泺口	luokou
泺源	luoyuan
泺源大街	luoyuandajie
泽头	zetou
洇溜	yinliu
洋中	yangzhong
洋桥	yangqiao
洋泾	yangjing
洋溪	yangxi
洗面桥	ximianqiao
洛溪	luoxi
洛碛	luoqi
洛社镇	luoshezhen
洛羊	luoyang
洛阳路	luoyanglu
洞井铺	dongjingpu
洞泾	dongjing
津南周边	jinnanzhoubian
津塘路	jintanglu
津头	jintou
津泰	jintai
洪城路	hongchenglu
洪塘	hongtang
洪家园	hongjiayuan
洪家楼	hongjialou
洪山坡	hongshanpo
洪山桥	hongshanqiao
洪广	hongguang
洪庆	hongqing
洪桥	hongqiao
洪武路	hongwulu
洪河	honghe
洪湾路	hongwanlu
洪蓝	honglan
洪都	hongdou
洪都中大道	hongduzhongdadao
洪都北大道	hongdubeidadao
洮昌	taochang
洲头	zhoutou
派潭	paitan
流亭	liuting
流花	liuhua
流芳	liufang
浆水泉路	jiangshuiquanlu
浆洗街	jiangxijie
济微路	jiweilu
济泺路	jiluolu
济源路	jiyuanlu
济齐路	jiqilu
济齐路西段	jiqiluxiduan
浏城桥	liuchengqiao
浏正街	liuzhengjie
浏阳河	liuyanghe
浏阳河路	liuyanghelu
浑河站东	hunhezhandong
浑河站西	hunhezhanxi
浒墅关	xushuguan
浒山	hushan
浣花小区	huanhua
浦上大道	pushangdadao
浦东外环	pudongwaihuan
浦沅	puyuan
浦沿	puyan
浦珠路	puzhulu
浮山新区	fushanxinqu
浮山路	fushanlu
海上世界	haishangshijie
海东路	haidonglu
海事大学	haishidaxue
海云庵	haiyunan
海伦路	hailunlu
海军广场	haijunguangchang
海口	haikou
海口路	haikoulu
海垦	haiken
海富路	haifulu
海尔路	haierlu
海幢	haizhuang
海府	haifu
海悦山小区	haiyueshanxiaoqu
海拉尔西路	hailaerxilu
海景御花园	haijingyuhuayuan
海棠	haitang
海棠溪	haitangxi
海棠路	haitanglu
海椒市	haijiaoshi
海浴路	haiyulu
海湾	haiwan
海湾旅游区	haiwanlvyouqu
海滨	haibin
海滨路	haibinlu
海滨迟家	haibinchijia
海滩街	haitanjie
海王大厦	haiwangdasha
海琴广场	haiqinguangchang
海甸	haidian
海石湾	haishiwan
海秀	haixiu
海辉街	haihuijie
海运仓	haiyuncang
海阳所	haiyangsuo
涂家冲	tujiachong
涂山	tushan
涑堤路	sudilu
涑河北路	suhebeilu
涑河南路	suhenanlu
润宇	runyu
涧河	jianhe
涪江二桥	fujiangerqiao
淀山湖	dianshanhu
淘金	taojin
淞南	songnan
淞宝	songbao
淡水	danshui
淮口	huaikou
淮河西路	huaihexilu
淮河路	huaihelu
淮海中路	huaihaizhonglu
淮海西路	huaihaixilu
淮海路	huaihailu
淮西客运站	huaixikeyunzhan
深圳湾	shenzhenwan
深圳路	shenzhenlu
深大北门	shendabeimen
淳城	chuncheng
淳溪	chunxi
清华路	qinghualu
清名桥	qingmingqiao
清和	qinghe
清明街	qingming
清水台	qingshuitai
清水塘	qingshuitang
清江	qingjiang
清河农场	qinghenongchang
清河北路	qinghebeilu
清河南路	qinghenanlu
清河路	qinghelu
清泉寨	qingquanzhai
清波	qingbo
清洋	qingyang
清溪路	qingxilu
清潭怀德	qingtanhuaide
清真巷	qingzhenxiang
渔阳	yuyang
渗坝	shenba
渝中周边	yuzhongzhoubian
渝北周边	yubeizhoubian
渝州路	yuzhoulu
渝碚路	yubeilu
渡舟	duzhou
渤海石油	haiyangshiyou
渤海镇	bohaizhen
温圳	wenzhen
温州商贸城	wenzhoushangmaocheng
温江城区	liucheng
温泉公园	wenquangongyuan
温泉路	wenquanlu
渭塘	weitang
渭源路	weiyuanlu
港务局	zhenjiang
港湾广场	gangwanguangchang
港湾街	gangwanjie
港西	gangxi
港门村	gangmencun
湖东	hudong
湖东路	hudonglu
湖光路	huguanglu
湖前	huqian
湖北路	hubeilu
湖南商学院	hunanshangxueyuan
湖南崖	hunanya
湖南财专	hunancaizhuan
湖南路	hunanlu
湖塘乐购	hutanglegou
湖墅	hushu
湖岛	hudao
湖景	hujing
湖滨东路	hubindonglu
湖滨北路	hubinbeilu
湖滨南路	hubinnanlu
湖滨新村	hubinxincun
湖父镇	hufuzhen
湖西	huxi
湖西街	huxijie
湖西路	huxi
湘江世纪城	xiangjiangshijicheng
湘江中路	xiangjiangzhonglu
湘江道	xiangjiangdao
湘湖路	xianghulu
湘潭路楼山	xiangtanluloushan
湘雅三医院	xiangyasanyiyuan
湘雅医院	xiangyayiyuan
湘雅路	xiangyalu
湘雅路口	xiangyalukou
湛山	zhanshan
煌逭	yingwanzhen
源深竹园	yuanshenzhuyuan
溧水县农场	lishuixiannongchang
溧水开发区	lishuikaifaqu
溪之谷	xizhigu
溪口	xikou
溪翁庄	xiwengzhuang
溪霞	xixia
滂江街	guancheng
滇池度假区	dianchidujiaqu
滇池路片区	fuhai
滑翔小区	huaxiang
滕王阁	tengwangge
滠口	shekou
满春	manchun
满都户	manduhu
滢水山庄	yingshuishanzhuang
滦镇	luanzhen
滨江东	binjiangdong
滨江路	binjianglu
滨江道	binjiangdao
滨河	pinggubinhe
滨河东路	binhedonglu
滨河大道	binhedadao
滨河西路	binhexilu
滨河路	binhelu
滨海路	binhailu
滨港路	binganglu
滨湖街道	binhujiedao
漆桥	qiqiao
演达片区	yandapianqu
漕宝路	caobaolu
漕宝路地铁	caobaoluditie
漕河	caohe
漕河泾	caohejing
漕泾	caojing
漪汾	yifen
潍坊	weifang
潍柴	weichai
潘塘	pantang
潘家园	panjiayuan
潘家坪	panjiaping
潘庄	panzhuang
潜龙花园	qianlonghuayuan
潞苑	luyuan
潭柘寺	taizhesi
潮海	chaohai
潮鸣	chaoming
澄江街道	chengjiangjiedao
势	xiepu
澳头	aotou
澳门路	aomenlu
餮	mengyang
濯水	zhuoshui
濯西	zhuoxi
瀛洲	yingzhou
渡	rangdu
灌口	guankou
火井	huojing
火星	huoxing
火炬大厦	huojudasha
火炬村	huojucun
火炬路	huojulu
火炼树	huolianshu
火车北站	lianmeng
火车南站	huochenanzhan
火车站	huochezhan
火车站周边	huochezhanzhoubian
火车西站	huochexizhan
灯市口	dengshikou
灵塔	lingta
灵山卫	lingshanwei
灵桥	lingqiao
灵隐	lingyin
炉院街	luyuanjie
炭步	tanbu
炮台	paotai
烈士公园	lieshigongyuan
热河南路	rehenanlu
热河路	rehelu
焦岱	jiaodai
焦石	jiaoshi
煎茶	jiancha
熊儿寨	xiongerzhai
熊家	xiongjia
燕儿岛路	yanerdaolu
燕子山路	yanzishanlu
燕子矶	yanziji
燕尔窝	yanerwo
燕山	yanshan
燕山立交	yanshanlijiao
燕庄	yanzhuang
燕莎	yansha
爱工街	aigongjie
爱建	aijian
爵溪	juexi
牌楼	pailou
牌楼路	pailoulu
牙膏厂	yagaochang
牛家牌	niujiapai
牛市口	niushikou
牛沙路	lianxin
牛王庙	niuwangmiao
牛玛	niuma
牛耳桥	niuerqiao
牛街	niujie
牛道口	niudaokou
牟礼	mouli
牡丹园	mudanyuan
犀浦	xipu
犁弯	liwan
狗街	goujie
独墅湖	dushuhu
独树村	dushucun
独流	duliu
狮山	shishan
狮岭	shiling
猎德	liede
猛追湾	mengzhuiwan
猴子石	houzishi
玄坛庙	xuantanmiao
玄武湖	xuanwuhu
玄武门	xuanwumen
玉凤路	yufenglu
玉函路	yuhanlu
玉双路	yushuanglu
玉堂	yutang
玉峰山	yufengshan
玉村	yucun
玉林	yulin
玉桥	yuqiao
玉泉营	yuquanying
玉泉路	yuquanlu
玉皇阁北街	yuhuanggebeijie
玉祁镇	yuqizhen
玉祥门	yuxiangmen
王串场	wangchuanchang
王兆	wangzhao
王卜庄	wangbozhuang
王口	wangkou
王哥庄	wanggezhuang
王官庄	wangguanzhuang
王家	wangjia
王家冲	wangjiachong
王家坡	wangjiapo
王家垅	wangjialong
王家巷	wangjiaxiang
王家桥	wangjiaqiao
王家沟	wangjiagou
王家湾	wangjiawan
王寺	wangsi
王庄	wangzhuang
王庄路	wangzhuanglu
王庆坨	wangqingtuo
王府井	wangfujing
王村南街	wangcunnanjie
王泗	wangsi
王浩儿	wanghaoer
王稳庄	wangwenzhuang
王舍人	wangsheren
王辛庄	wangxinzhuang
王连	wanglian
王顶堤	wangdingdi
玛克威	chongjian
玫瑰大楼	meiguidalou
环城	huancheng
环城北路	huanchengbeilu
环城南路	huanchengnanlu
环城西路	huanchengxilu
环城路	huanchenglu
环山路	huanshanlu
环岛公园	huandaogongyuan
环市东	huanshidong
环市中	huanshizhong
环市西	huanshixi
环河街	huanhejie
环秀	huanxiu
现代广场	xiandaiguangchang
玲珑	linglong
珍溪	zhenxi
珞南	luonan
珞狮南路	luoshinanlu
珞珈山	luojiashan
珠吉	zhuji
珠林	zhulin
珠江新城	zhujiangxincheng
珠江桥	kejian
珠江路	zhujianglu
珠海	zhuhai
珠海路	zhuhailu
班觉林	banjiaolin
珲春街	huichunjie
球场街	qiuchang
琅岐	langqi
琅琊王路	langyawanglu
理工大学	ligongdaxue
理想新城	lixiangxincheng
琥珀山庄	hupo
琴断口	qinduankou
琶洲	pazhou
瑞宝	ruibao
瑞昌路	ruichanglu
瑞金路	ruijinlu
瑶琳	yaolin
璜土镇	huangtuzhen
甘丹曲果	gandanquguo
甘宁	ganning
甘家口	haidianganjiakou
甘河滩	ganhetan
甘泉路	ganquanlu
甘溪	ganxi
甘露园	ganluyuan
甜水井	lianhutianshuijing
甜水园	tianshuiyuan
生产路	shengchanlu
生米	shengmi
f直	luzhi
田和街区	tianhejiequ
田地街	tiandijie
田家寨	tianjiazhai
田心村	tianxincun
田村	tiancun
田贝	tianbei
甲子	jiazi
甲玛	jiama
申中	shenzhong
申港街道	shengangjiedao
申花	shenhua
电大街	diandajie
电子城	dianzicheng
电子正街	dianzizhengjie
电视塔	dianshita
甸柳新村	dianliuxincun
界石	jieshi
留下	liuxia
留医部	liuyibu
留园	liuyuan
留村	liucun
留营	liuying
瘦西湖	shouxihu
登仕堡子	dengshipuzi
登峰	dengfeng
登州路	dengzhoulu
登沙河	dengshahe
白云大道北	baiyundadaobei
白云大道南	baiyundadaonan
白云新村	baiyunxincun
白云街	baiyunjie
白佛	baifo
白古屯	baigutun
白合	baihe
白土	wanzhoubaitu
白坭	baini
白塔路	baitalu
白头	baitou
白家	baijia
白山路	baishanlu
白市驿	baishiyi
白广路	baiguanglu
白杨	baiyang
白果	baiguo
白果林	baiguolin
白水井	baishuijing
白水坝	baishuiba
白沙	baisha
白沙大道	baishadadao
白沙岭	baishaling
白沙洲	baishazhou
白沙淮	baishahuai
白沙街	baishajie
白沙路	baishalu
白洋湾	baiyangwan
白涛	baitao
白涧	baijian
白湖亭	baihuting
白玉山	baiyushan
白石	baishi
白石桥	baishiqiao
白石洲	baishizhou
白石路文化路	baishiluwenhualu
白纸坊	baizhifang
白羊	baiyang
白菊	baiju
白蕉镇	baijiaozhen
白银路	baiyinlu
白马	baima
白马北路	baimabeilu
白马南路	baimananlu
白马山	baimashan
白鹅潭	baietan
白鹤	baihe
白鹤洞	baihedong
白鹭花园	bailuhuayuan
白鹿	bailu
白龙	bailong
白龙路片区	bailonglupianqu
百万庄	baiwanzhuang
百丈	baizhang
百佳	baijia
百合山庄	baiheshanzhuang
百善	baishan
百子湾	baiziwan
百安坝	baianba
百家湖	baijiahu
百步亭	baibuting
百汇街	baihuijie
百汇购物中心	baihuigouwuzhongxin
百江	baijiang
百济	baiji
百盛滨海广场	baishengbinhaiguangchang
百胜	baisheng
百花中心站	baihuazhongxinzhan
百花井	baihuajing
百花洲	baihuazhou
百货大楼	baihuodalou
百鸟公园	bainiaogongyuan
皂君庙	zaojunmiao
皇冠	huangguan
皇姑屯火车站	huanggutun
皇寺	beizhan
皇岗	huanggang
皋兰路	gaolanlu
皓月大路	haoyuedalu
益民	yimin
益田村	yitiancun
盐场	yanchang
盐市口	yanshikou
盐步	yanbu
盖家沟	gaijiagou
盖州街	gaizhoujie
盘城	pancheng
盘旋路	panxuanlu
盘福路	panfulu
盘龙城	panlongcheng
盛岸路	shenganlu
盛泽	shengze
盛能游乐	shengnengyouyue
相公	xianggong
相思湖新区	xiangsihuxinqu
省人大	shengrenda
省人才	shengrencai
省人防办	shengrenfangban
省体中心	shengtizhongxin
省军区	shengjunqu
省农机校	shengnongjixiao
省博物馆	shengbowuguan
省实验	shengshiyan
省展览馆	shengzhanlanguan
省政府	shengzhengfu
真光新村	zhenguangxincun
真如	zhenru
真新新村	zhenxinxincun
知春路	zhichunlu
石井	shijing
石井区	shijingqu
石井坡	shijingpo
石会	shihui
石佛营	shifoying
石佛镇	shifozhen
石化	shihua
石厦	shisha
石各庄	wuqingshigezhuang
石园	shiyuan
石坝	shiba
石坪	shiping
石坪桥	shipingqiao
石埠	shibu
石堰	shiyan
石塘	shitang
石子冲	shizichong
石家河	shijiahe
石岗	shigang
石岛区	shidaoqu
石岩	shiyan
石板	shiban
石板滩	shibantan
石桥铺	shiqiaopu
石沟屯	shigoutun
石沱	shituo
石油大学	shiyoudaxue
石油新村	shiyouxincun
石泉路	shiquanlu
石洞	shidong
石湫	shiqiu
石湾	shiwan
石滩	shitan
石牌	shipai
石	shiqi
石\	shishiqi
石祥路	shixianglu
石纺路	shifanglu
石羊	wuhoushiyang
石羊桥东路	shiyangqiaodonglu
石美	shimei
石老人	shilaoren
石船	shichuan
石葵路	shikuilu
石路	shilu
石道街	shidaojie
石钟	shizhong
石铜路	shitonglu
石马河	shimahe
石鼓路	shigulu
石鼻	shibi
矿区医院	kuangquyiyuan
矿大	kuangda
矿山	kuangshan
矿市	kuangshi
矿泉	kuangquan
砂子塘	yuhuashazitang
砂山	shakou
砖墙	zhuanqiang
砚池街	yanchijie
砚瓦池	yanwachi
硅谷广场	guiguguangchang
硕放	shuofang
碧云	biyun
碧沙岗	bishagang
碧湘街	bixiangjie
碧谷	bigu
碧鸡	biji
碱泉	jianquan
磁器口	ciqikou
磁峰	cifeng
磁窑堡	ciyaobao
磨子桥	moziqiao
礼嘉	lijia
礼明庄	limingzhuang
礼让街	lirangjie
祁家湾	qijiawan
祈福	qifu
p滨路	fangbinlu
祖庙	zumiao
祝丘路	zhuqiulu
祝华	zhuhua
祝塘镇	zhutangzhen
祝桥	zhuqiao
祝甸	zhudian
神仙树	shenxianshu
神山	shenshan
祥和	xianghe
祥平	xiangping
祥瑞路	ruixianglu
禄口	lukou
福兴	fuxing
福利路	fulilu
福升	fusheng
福华新村	fuhuaxincun
福华街	fuhuajie
福和	fuhe
福州北路	fuzhoubeilu
福州南路	fuzhounanlu
福建园	fujianyuan
福建路	fujianlu
福新中路	fuxinzhonglu
福明	fuming
福民新村	fuminxincun
福永	fuyong
福海路	fuhailu
福田区委	futianquwei
福马路	fumalu
禾山	heshan
禾祥西路	hexiangxilu
秀厢大道	xiuxiangdadao
秀月街	xiuyuejie
秀水河子	xiushuihezi
秋林	qiulin
科园大道	keyuandadao
科大西区	kedaxiqu
科学园	kexueyuan
科学城	kexuecheng
科技一路	kejiyilu
科技二路	kejierlu
科技四路西段	kejisiluxiduan
科技园	kejiyuan
科技园区	kejiyuanqu
科技城	kejicheng
科技路西口	kejiluxikou
科教新村	kejiaoxincun
秣陵	moling
秦岭路	qinlinglu
秦虹	qinhong
秦陵	qinling
积水潭	jishuitan
积玉桥	jiyuqiao
积米崖	jimiya
程家桥	chengjiaqiao
程林	chenglinjie
程林庄	chenglinzhuang
稻香村	daoxiangcun
穆家峪	mujiayu
穗东	suidong
穷达	qiongda
穿芳峪	chuanfangyu
窑岭	yaoling
窖口	jiaokou
窦店	doudian
立岗	ligang
立水桥	lishuiqiao
站前商场	zhanqianshangchang
站前西路	zhanqianxilu
站北	zhanbei
站街	zhanjie
章多	zhangduo
童家桥	tongjiaqiao
童家溪	tongjiaxi
竹公溪	zhugongxi
竹子林	zhuzilin
竹山园	zhushanyuan
竹山路	zhushanlu
竹料	zhuliao
竹篙	zhugao
竹苑	zhuyuan
笋岗	sungang
笔架山	bijiashan
笕桥	jianqiao
第一大街	diyidajie
第一师范	diyishifan
第一津街	diyijinjie
第三大街	disandajie
第二大街	dierdajie
第五大街	diwudajie
第四大街	disidajie
等驾坡	dengjiapo
oY	yundang
算圣巷	suanshengxiang
管南片	guannanpian
管城区委	guanchengquwei
管庄	guanzhuang
簇桥	cuqiao
籍田	jitian
米山	mishan
米市巷	mishixiang
粤垦	yueken
粮道	liangdao
粮道街	liangdaojie
精英中学	jingyingzhongxue
系马桩	ximazhuang
素社	sushe
索凌路	suolinglu
紫坪铺	zipingpu
紫竹桥	zizhuqiao
紫荆	zijing
紫荆山路	zijingshanlu
繁荣路	fanronglu
红光	hongguang
红光农场	hongguangnongchang
红军大街	hongjundajie
红凌路	honglinglu
红城	hongcheng
红岗花园	hongganghuayuan
红岛	hongdao
红岩	hongyan
红庙	hongmiao
红庙坡	hongmiaopo
红旗大街	hongqidajie
红旗小区	hongqixiaoqu
红旗河沟	hongqihegou
红旗渠	hongqiqu
红旗药号	hongqiyaohao
红旗街	hongqi
红旗路	hongqilu
红星村	hongxingcun
红星美凯龙	hongxingmeikailong
红星街	hongxingjie
红星路	hongxinglu
红枫湖	hongfenghu
红桥周边	hongqiaozhoubian
红梅	hongmei
红梅北环	hongmeibeihuan
红牌楼	hongpailou
红石崖	hongshiya
红花	honghua
红莲	honglian
红钢城	honggangcheng
红阳	hongyang
纬北路	weibeilu
纱帽	shamao
纳木湖	namuhu
纸坊	zhifang
纺织城	fangzhicheng
绍兴路	shaoxinglu
经一路	jingyilu
经七纬十二	jingqiweishier
经七路	jingqilu
经三路	jingsanlu
经二路	jingerlu
经五路	jingwulu
经八路	guanchenghuizujingbalu
经十东路	jingshidonglu
经十西路	jingshixilu
经十路中段	jingshiluzhongduan
经十路历下段	jingshilulixiaduan
经济技术开发区	jingjijishukaifaqu
经纬街	jingwei
统景	tongjing
续普	xupu
续迈	xumai
绳金塔	shengjinta
维明	weiming
绿东村	lvdongcun
绿地老街	lvdilaojie
绿景	lvjing
绿波	lvbo
罗七路	luoqilu
罗云	luoyun
罗五路	luowulu
罗亭	luoting
罗八路	luobalu
罗六路	luoliulu
罗冲围	luochongwei
罗四路	luosilu
罗家	luojia
罗庄医院	luozhuangyiyuan
罗庄子	luozhuangzi
罗店	luodian
罗星	luoxing
罗村	luocun
罗汉寺	luohansi
罗沙	luosha
罗泾	luojing
罗湖区委	luohuquwei
罗溪	luoxi
羊亭	yangting
羊八井	yangbajing
羊安	yangan
羊尖	yangjian
羊昌	yangchang
羊达	yangda
羊马	yangma
美丽365花园	meili365huayuan
美里湖	meilihu
美食街	meishijie
群力	sidalin
群英	qunying
羲之路	xizhilu
翔运街	xiangyunjie
翟家	zhaijia
翟营	zhaiying
翟营大街	zhaiyingdajie
翠华路	cuihualu
翠微	cuiwei
翠月湖	cuiyuehu
翠柏路	cuibailu
翠湖	cuihu
翠竹	cuizhu
翠苑	cuiyuan
翻身路	fanshenlu
老代庄	laodaizhuang
老余杭	laoyuhang
老公园	laogongyuan
老军营	laojunying
老北站	laobeizhan
老山	laoshan
老瓜堡	laoguabao
老福山	laofushan
老虎滩	hutan
老西门	laoximen
老闵行	laominhang
老香洲	laoxiangzhou
老鳖湾	laobiewan
老鸦陈	laoyachen
聂唐	nietang
聂寨	niezhai
职工新村	zhigongxincun
联丰路	lianfenglu
联合	lianhe
联想桥	lianxiangqiao
联洋	lianyang
联盟	lianmeng
聚才路	jucailu
聚源	juyuan
聚贤街	juxianjie
肇嘉浜路	zhaojiabanglu
肇工街	zhaogongjie
肉联厂	roulianchang
肖坝	xiaoba
肖家河	xiaojiahe
肖寨门	xiaozhaimen
育才路	yucailu
育黎	yuli
胜利	shengli
胜利桥	shengliqiao
胜利桥北	shengliqiaobei
胜利街	shengli
胜利路	shenglilu
胜北	shengbei
胜南	shengnan
胜太路	shengtailu
胜浦	shengpu
胡埭镇	hudaizhen
胡家园	hujiayuan
胡家庙	hujiamiao
胥口	xukou
胥家	xujia
胥江	xujiang
胶州路	jiaozhoulu
能仁里	nengrenli
腊山北路	lashanbeilu
腾家	tengjia
自强街	ziqiang
自强路	ziqianglu
自由大路	ziyoudalu
自行车厂	zixingchechang
致和	zhihe
致民路	zhiminlu
致韩	zhihan
舜华路	shunhualu
舜玉路	shunyulu
舜耕路	shungenglu
舟白	zhoubai
航华	hanghualongbai
航天桥	hangtianqiao
航头	hangtou
航海东路	hanghaidonglu
航海西路	hanghaixilu
航空港	hangkonggang
航空路	hangkonglu
船山路	nanpu
船房片区	chuanfangpianqu
船舶	chuanbo
艮山	genshan
良乡	liangxiang
良口	liangkou
良渚	liangzhu
良王庄	liangwangzhuang
良田	liangtian
色麦	semai
艳山红	yanshanhong
艳粉	yanfen
艾维尔沟	aiweiergou
芍药居	shaoyaoju
芙蓉中路	furongzhonglu
芙蓉北路	furongbeilu
芙蓉区政府	furongquzhengfu
芙蓉南路	furongnanlu
芙蓉周边	furongzhoubian
芙蓉广场	furongguangchang
芙蓉汉城	furonghancheng
芙蓉苑	furongyuan
芜湖路	wuhulu
芝罘区	zhifuqu
芥园道	jieyuandao
芦台	lutai
芦台经济开发区	lutaijingjikaifaqu
芦家街	lujia
芦苞	lubao
花东	huadong
花乡	huaxiang
花侨	huaqiao
花冲公园	huachonggongyuan
花卉园	huahuiyuan
花园	pixianhuayuan
花园小区	huayuanxiaoqu
花园新村	huayuanxincun
花园桥	huayuanqiao
花园白云	huayuanbaiyun
花园路	guanchenghuizuhuayuanlu
花地湾	huadiwan
花城路	huachenglu
花家地	huajiadi
花岗	huagang
花市	huatan
花庄	huazhuang
花木	huamu
花桥	huaqiao
花水湾	huashuiwan
花源	xinjinhuayuan
花牌坊	huapaifang
芳村	fangcun
芳桥镇	fangqiaozhen
芳草街	fangcaojie
芷江西路	zhijiangxilu
苇湖梁	weihuliang
苇湾	weiwan
苍霞	cangxia
苏圃路	supulu
苏圩	suxu
苏坡	supo
苏家	sujia
苏州	suzhou
苏州街	suzhoujie
苏苑	suyuan
苏锦	sujin
苑东	yuandong
苗圃	miaopu
苗庄	miaozhuang
苘山	qingshan
苜蓿园	muxuyuan
英华街	yinghuajie
英才街	yingcaijie
英达	yingda
英雄山路	yingxiongshanlu
苹果园	pingguoyuan
茄子溪	qiezixi
茨坝	ciba
茨榆坨	ciyutuo
茨竹	wanzhoucizhu
茶亭	chating
茶会	chahui
茶南	chanan
茶园	chayuan
茶园坡	chayuanpo
茶园新区	chayuanxinqu
茶巴拉	chabala
茶巴朗	chabalang
茶店子	chadianzi
茶淀	chadian
草场街	caochangjie
草埔	caobu
草堂	caotang
草市街	caoshijie
草庙子	caomiaozi
草桥	caoqiao
草滩	caotan
草甸	caodian
草铺	caopu
荔枝	lizhi
荔枝公园	lizhigongyuan
荔枝沟	lizhigou
荔湾路	liwanlu
荔联	lilian
荣业大街	rongyedajie
荣光	rongguang
荣华	ronghua
荣巷	rongxiang
荫子	yinzi
药六	yaoliu
药山	yaoshan
荷兰村	helancun
荷包湖	hebaohu
荷叶地	heyedi
荷叶塘	heyetang
荷城	hecheng
荷花园	hehuayuan
荷花坑	hehuakeng
荷花池	hehuachi
荷花路	hehualu
莘庄	shenzhuang
莘闵	shenmin
莞城中心	guanchengzhongxin
莫干山路	moganshanlu
莫愁	mochou
莱山区	laishanqu
莱蒙都会	laimengduhui
莲前	lianqian
莲前东路	lianqiandonglu
莲前西路	lianqianxilu
莲坂	lianban
莲塘	liantang
莲桂路	guilianlu
莲池小学	lianchixiaoxue
莲花一村	lianhuayicun
莲花三村	lianhuasancun
莲花二村	lianhuaercun
莲花北村	lianhuabeicun
莲花山	lianhuashan
莲花片区	lianhua
菊园新区	juyuanxinqu
菜园坝	yuzhongcaiyuanba
菜市口	caishikou
菜户营	caihuying
菜纳	caina
菜艺街	liushun
萝岗镇	luogangzhen
营城	yingcheng
营城子	yingchengzi
营市街	yingshijie
营盘路	yingpanlu
营门口	yingmenkou
萧王庙	xiaowangmiao
葑门	fengmen
葛仙山	gexianshan
葛兰	gelan
葛化	gehua
葛塘	getang
葛大店	gedadian
葛家	gejia
葛沽	gegu
董场	dongchang
董家渡	dongjiadu
董家湾	dongjiawan
董家窑	dongjiayao
葵巷	kuixiang
葵涌	kuichong
葵英街	caiying
蒋家垅	jiangjialong
蒋巷	jiangxiang
蒋村	jiangcun
蒙山大道	mengshandadao
蒲庙	pumiao
蒲河	puhe
蒲花	puhua
蒲阳	puyang
蒲黄榆	puhuangyu
蒿泊	haobo
蓝天	lantian
蓟门桥	jimenqiao
蓬东	pengdong
蓬莱公园	penglaigongyuan
蔡公庄	caigongzhuang
蔡场	caichang
蔡家岗	caijiagang
蔡屋围	caiwuwei
蔡锷北路	caiebeilu
蔡锷南路	caienanlu
蔡锷南路口	caienanlukou
蔺市	linshi
薛家岛	xuejiadao
藏雄	cangxiong
虎丘	jinchanghuqiu
虎台	hutai
虎坊桥	hufangqiao
虎山	hushan
虎山路	hushanlu
虎溪	huxi
虎石台	hushitai
虎踞路	hujulu
虎门公园	humengongyuan
虹山片区	hongshanpianqu
虹桥	changninghongqiao
虹苑路	hongyuanlu
蛇口	shekou
蛟川	jiaochuan
蛟桥	jiaoqiao
蜀汉路	shuhanlu
蜜蜂张	mifengzhang
蠡园	liyuan
蠡湖街道	lihujiedao
行政中心	xingzhengzhongxin
行者	hangzhe
街口	jiekou
街子	jiezi
街道口	jiedaokou
衙门口	yamenkou
衡山路	hengshanlu
衡阳	hengyang
衡阳路	hengyanglu
袁家岗	yuanjiagang
袁家岭	yuanjialing
裕东	yudong
裕兴	yuxing
裕南街	yunanjie
裕强	yuqiang
裕西	yuxi
西一路	xiyilu
西三庄	xisanzhuang
西三教	xisanjiao
西三旗	xisanqi
西三道街	xisandaojie
西中华路	xizhonghualu
西丽	xili
西二旗	xierqi
西二环	xierhuan
西二环南路	xierhuannanlu
西于庄	xiyuzhuang
西五	xiwu
西五路	xiwulu
西京医院	xijingyiyuan
西京大学	xijingdaxue
西便门	xibianmen
西兆通	xizhaotong
西关	xiguan
西关什字	xiguanshizi
西关大街	xiguandajie
西兴	xixing
西北	xibei
西北旺	xibeiwang
西北湖	xibeihu
西华路	xihualu
西单	xidan
西南	xinan
西南科技大学	xinankejidaxue
西南财大	xinancaida
西南路	xinanlu
西厂门	xichangmen
西善桥	xishanqiao
西四	xisi
西四道街	xisidaojie
西园	xiyuan
西园新村	xiyuanxincun
西固城	xigucheng
西坝河	xibahe
西坞	xiwu
西堤头	xiditou
西塔	xita
西大直街	songhuajiang
西大街	xidajie
西姜	xijiang
西安大路	xiandalu
西安广场	xianguangchang
西安桥	xianqiao
西安桥外	xianqiaowai
西安路	xianlu
西客站	xuanwuxikezhan
西宫	xigong
西山区政府	xishanquzhengfu
西山水库	xishanshuiku
西山驿	xishanyi
西岭	xiling
西市场	xishichang
西广场	xiguang
西康路	xikanglu
西彭	xipeng
西影路	xiyinglu
西把栅乡政府	xibazhaxiangzhengfu
西新	xixin
西新桥	xixinqiao
西朝阳路	xichaoyanglu
西村	xicun
西来	xilai
西柯	xike
西柳沟	xiliugou
西桥路	xiqiaolu
西槎路	xicuolu
西樵	xiqiao
西永	xiyong
西江滨	xijiangbin
西沽	xigu
西泡	xipao
西浴场	xiyuchang
西渚镇	xizhuzhen
西渡	xidu
西湖路	xihulu
西溪	xixi
西焦	xijiao
西直门	xichengxizhimen
西稍门	xishaomen
西站	hezuohuabeilu
西红门	xihongmen
西罗园	xiluoyuan
西翟庄	xizhaizhuang
西花园路	xihuayuanlu
西苑	xiyuan
西苑街区	xiyuanjiequ
西营门	xiyingmen
西藏北路	xizangbeilu
西藏南路	xizangnanlu
西街	xijie
西部工业区	xibugongyequ
西部通道	xibutongdao
西里	xili
西镇	xizhen
西长街	xizhangjie
西门	ximen
西门口	ximenkou
西门路	ximenlu
西青周边	xiqingzhoubian
西香坊	xixiangfang
西马	xima
西龙王庙	xilongwangmiao
西龙虎峪	xilonghuyu
覃家岗	tanjiagang
观前	guanqian
观沙岭	guanshaling
观海路	guanhailu
观澜	guanlan
观胜	guansheng
观音岩	guanyinyan
观音桥	guanyinqiao
角美	jiaomei
角门	jiaomen
解放东路	jiefangdonglu
解放中路	jiefangzhonglu
解放北	jiefangbei
解放北路	jiefangbeilu
解放南	jiefangnan
解放南路	jiefangnanlu
解放四村	jiefangsicun
解放大路	jiefangdalu
解放广场	jiefangguangchang
解放碑	jiefangbei
解放西街	jiefangxijie
解放西路	jiefangxilu
解放路	jiefanglu
解放门	jiefangmen
詹家溪	zhanjiaxi
警钟街	jingzhongjie
许坦东西街	xutandongxijie
许家台	xujiatai
许府巷	xufuxiang
识字岭	shiziling
诗书	shishu
诸往	zhuwang
谈固	tangu
谈固大街	tangudajie
谌家矶	chenjiaji
谢家湾	xiejiawan
豆各庄	dougezhuang
豆张庄	douzhangzhuang
象园	xiangyuan
象山北路	xiangshanbeilu
象山南路	xiangshannanlu
象湖新城	xianghuxincheng
豫园	yuyuan
豫章	yuzhang
贝森	beisen
贡元巷	gongyuanxiang
财富广场	caifuguangchang
财落	cailuo
贤士二路	xianshierlu
购物公园	gouwugongyuan
贵乌路	guiniaolu
贵和	guihe
贵阳街	guiyangjie
费家营	feijiaying
贺丞路	hechenglu
贾庄	jiazhuang
赛维拉	saiweila
赛罕区政府	saihanquzhengfu
赛虹桥	saihongqiao
赛马场	saimachang
赣水路	ganshuilu
赤坭	chini
赤尾	chiwei
赤岗	chigang
赤岗冲	chigangchong
赤岗岭	chigangling
赤岭路	chilinglu
走马	wanzhouzouma
走马岭	zoumaling
赵公口	zhaogongkou
赵家	zhaojia
赵巷	zhaoxiang
赵镇	zhaozhen
赵陵铺	zhaolingpu
越溪	yuexi
越秀路	yuexiulu
趵突泉	baotuquan
趵突泉北路	zhonggongbaotuquanbeilu
跃进村	yuejincun
跃进街	yuejinjie
跃进路	yuejin
跃龙	yuelong
路南	lunan1
路官	luguan
跳伞塔	tiaosanta
跳石	tiaoshi
跳磴	tiaodeng
跳蹬河	tiaodenghe
车公庄	chegongzhuang
车公庙	chegongmiao
车家村	chejiacun
车站	chezhan
车站北路	chezhanbeilu
车站大道	chezhandadao
车管所	cheguansuo
车轮厂	chelunchang
车道沟	chedaogou
车陂	chebei
转塘	zhuantang
转龙	zhuanlong
软件园	ruanjianyuan
轴承厂	zhouchengchang
较场口	jiaochangkou
辉南街	huinanjie
辉山	huishan
辛口	xinkou
辛安	xinan
辛安渡	xinandu
辛家庄	xinjiazhuang
辛家庙	xinjiamiao
辛寨子	xinzhaizi
辛庄	xinzhuang
边家村	bianjiacun
辽宁路	liaoninglu
辽师	liaoshi
辽沈	liaoshen
辽河街	liaohe
辽河西路	liaohexilu
辽源路	liaoyuanlu
辽滨	liaobin
辽阳街	liaoyangjie
达嘎	daga
达龙	dalong
迈皋桥	maigaoqiao
迎宾大道	daishan
迎宾街	yingbin
迎宾路	yingbinlu
迎新街	yingxinjie
迎新路	yingxinlu
迎春大街	yingchundajie
迎春街	yingchunjie
迎泽西大街	yingzexidajie
迎风	yingfeng
迎龙	yinglong
迎龙桥	yinglongqiao
运动系	yundongxi
运河东	yunhedong
运河北路	yunhebeilu
运河西	yunhexi
近江	jinjiang
进乡街	jinxiang
远洋城	yuanyangcheng
远洋路	yuanyanglu
远达	yuanda
连江南路	lianjiangnanlu
连江路	lianjianglu
连然	lianran
逍遥津	xiaoyaojin
通乡商店	tongxiang
通伸	tongshen
通化路	tonghualu
通天	tongtian
通安	tongan
通桥	tongqiao
通江大道	tongjiangdadao
通河新村	tonghexincun
通河西城区	tonghexichengqu
通泰街	tongtaijie
通泰路	tongtailu
通济	tongji
通达南路	tongdananlu
通达街	tongda
通达路	tongdalu
通道街	tongdaojie
造化	zaohua
造甲城	zaojiacheng
逢源	fengyuan
逢源商业街	fengyuanshangyejie
道义	daoyi
道德街	daodejie
道明	daoming
遵义路	zunyilu
邓南	dengnan
邓双	dengshuang
邗江工业园	hanjianggongyeyuan
邢台路	xingtailu
那楼	nalou
那洪	nahong
那陈	nachen
那马	nama
邦均	bangjun
邦堆	bangdui
邵公庄	shaogongzhuang
邻封	linfeng
邻海园	linhaiyuan
邻鄂	line
邾城	zhucheng
郎茂山	langmaoshan
郑州路	zhengzhoulu
郑店	zhengdian
郑旺	zhengwang
郑汴路	zhengbianlu
郝各庄	haogezhuang
郝官屯	haoguantun
郝庄	haozhuang
郫筒	pitong
郭家沱	guojiatuo
郭巷	guoxiang
郭村	guocun
郭杜	guodu
郭茨口	guocikou
都拉营	dulaying
都正街	douzhengjie
鄂尔多斯东街	eerduosidongjie
鄂尔多斯路	eerduosilu
酒仙桥	jiuxianqiao
酒店	jiudian
酒泉路	jiuquanlu
采荷	caihe
里水	lishuiqu
重固	zhonggu
重工	zhonggong
重庆南路	zhongqingnanlu
重庆路	chongqing
重沟	chonggou
金三角	jinjiajie
金中	jinzhong
金乔	jinqiao
金刀峡	jindaoxia
金匮街道	jinkuijiedao
金华	jinhua
金口	jinkou
金口路	jinkoulu
金地商都	jindishangdu
金坛路	jintanlu
金宇	jinyu
金尚路	jinshanglu
金山中部	jinshanzhongbu
金山卫	jinshanwei
金山大道	jinshan
金山小区	jinshanxiaoqu
金山新城	jinshanxincheng
金星	jinxing
金星大道	jinxingdadao
金星立交桥	jinxinglijiaoqiao
金杨新村	jinyangxincun
金柱园	jinzhuyuan
金桥	jinqiao
金殿片区	jindianpianqu
金水东路	jinshuidonglu
金水桥	jinshuiqiao
金水路	jinshuilu
金汇	jinhui
金沙江路	jinshajianglu
金沙洲	jinshazhou
金沟寨	jingouzhai
金河	jinhe
金泉	jinquan
金洞	jindong
金海湖	jinhaihu
金海湾	jinhaiwan
金源小区	jinyuanxiaoqu
金源路	jinyuanlu
金盆岭	jinpenling
金石滩	jinshitan
金碧片区	jinbi
金稻田	jindaotian
金竹	xiaohejinzhu
金箔路	jinbolu
金胜	jinsheng
金花	jinhua
金花路	jinhualu
金花镇	jinhuaqiao
金虹桥	jinhongqiao
金融街	jinrongjie
金贵	jingui
金贸	jinmao
金银湖	jinyinhu
金门路	jinmenlu
金陵小区	jinlingxiaoqu
金陵镇	jinlingzhen
金雀山路	jinqueshanlu
金霞路	jinxialu
金顶街	jindingjie
金马	jinma
金马路	jinmalu
金鸡岭	jinjiling
金龙	jinlong
钟公庙	zhonggongmiao
钟家村	zhongjiacun
钟村	zhongcun
钟林路	zhonglinlu
钟落潭	zhongluotan
钟鼓楼	zhonggulou
钢花村	ganghuacun
钢都	hongweilu
钢铁路	gangtielu
钱桥街道	qianqiaojiedao
钱江新城	qianjiangxincheng
铁东路	tiedonglu
铁北	tiebei
铁厂	tiechang
铁友	tieyou
铁山坪	tieshanping
铁峰	tiefeng
铁心桥	tiexinqiao
铁百	tiebai
铁西体育场	qinggong
铁西区政府	tiexiquzhengfu
铁西广场	tiexiguangchang
铁路东村街	tieludongcunjie
铁路西村	tieluxicun
铁道学院	tiedaoxueyuan
铃铛阁	lingchengge
铜元局	tongyuanju
铜罐驿	tongguanyi
铜陵路	tonglinglu
铭功路	minggonglu
铭熙水岸	mingxishuian
银峰路	yinfenglu
银川西路	yinchuanxilu
银川路	yinchuanlu
银桥街	yinqiaojie
银江路	yinjianglu
银湖	yinhu
银湖路	yinhulu
银滩	yintan
银盆岭	yinpenling
银通	yintong
银雀山路	yinqueshanlu
锁金村	suojincun
错埠岭	cuobuling
锡北	xibei
锡林路	xilinlu
锡沪路	xihulu
锦园小区	jinyuanxiaoqu
锦城	jincheng
锦水路	jinshuilu
锦泰广场	jintaiguangchang
锦溪	jinxi
锦程	jincheng
锦绣	jinxiu
锦绣江南	jinxiujiangnan
锦龙	jinlong
镇宁路	zhenninglu
镇江路	zhenjianglu
镇湖	zhenhu
镇罗营	zhenluoying
镇龙	zhenlong
长临河	changlinhe
长久路	changjiulu
长乐中路	zhanglezhonglu
长乐坊	zhanglefang
长乐宫	changlegong1
长乐西路	changlexilu
长乐路	changlelu
长兴岛	changxingdao
长兴路	changxinglu
长凌	zhangling
长和廊	zhanghelang
长坪	zhangping
长城路	changchenglu
长埠	zhangbu
长塘镇	zhangtangzhen
长安区政府	zhanganquzhengfu
长安周边	zhanganzhoubian
长安街道	changanjiedao
长安路	zhanganlu
长客	changke
长寿湖	changshouhu
长寿路	zhangshoulu
长庆	changqing
长庆街	changqingjie
长延堡	zhangyanbao
长征	changzheng
长征街	changzhengjie
长新街	changxinjie
长春理工大学	changchunligongdaxue
长春路	changchunlu
长桥	changqiao
长椿街	changchunjie
长江大道	changjiangdadao
长江批发市场	changjiangpifashichang
长江街	changjiang
长江路	zhangjianglu
长沙卷烟厂	zhangshajuanyanchang
长沙理工大学	zhangshaligongdaxue
长河	changhe
长治路	changzhilu
长泾镇	zhangjingzhen
长海县	changhaixian
长淮	changhuai
长湖路	changhulu
长	changban
长滩	changtan
长生桥	zhangshengqiao
长白新村	zhangbaixincun
长白街	changbaijie
长缨东路	zhangyingdonglu
长芦	changlu
长虹大道	changhongdadao
长虹街	changhong
长虹路	changhonglu
长辛店	changxindian
长通路	changtong
长阳路	zhangyanglu
长陵	changling
长青	zhangqing
长顺街	shaocheng
长风新村	zhangfengxincun
长风街	changfengjie
门巴	menba
闲林	xianlin
闵子骞路	minziqianlu
闸北公园	zhabeigongyuan
闸弄口	zhanongkou
闻堰	wenyan
闽江	minjiang
闽江大道	minjiangdadao
闽江路	minjianglu
阅江楼	minjianglou
阎村	yancun
阜安	fuan
阜成门	fuchengmen
阜新路	fuxinlu
阳光新路	yangguangxinlu
阳坊	yangfang
阳山镇	yangshanzhen
阳明东路	yangmingdonglu
阳明路	yangminglu
阳江	yangjiang
阳澄湖	yangchenghu
阳翟路	yangzhailu
阳逻	yangluo
阿尔泰游乐园	aertaiyouleyuan
阿弥岭	amiling
阿朗	alang
陆家	lujia
陆家嘴	lujiazui
陆慕	lumu
陇海东路	longhaidonglu
陇海西路	longhaixilu
陇海马路	longhaimalu
陈嘴	chenzui
陈坪	chenping
陈塘庄	chentangzhuang
陈官屯	chenguantun
陈家坝	chenjiaba
陈家坪	chenjiaping
陈家桥	chenjiaqiao
陈家湖	chenjiahu
陈家湾	chenjiawan
陈家祠	chenjiaci
陈家镇	chenjiazhen
陈寨	chenzhai
陈村	chencun
陵东	lingdong
陵西	huanggulingxi
陶吴镇	taowuzhen
陶家	taojia
陶然亭	taoranting
陶然路	taoranlu
陶瓷城	taocic
陶瓷科技城	taocikejicheng
隆丰	longfeng
隆兴	longxing
隆盛	longsheng
隆礼路	longlilu
雁山立交桥	yanshanlijiaoqiao
雁栖	yanqi
雁滩	yantan
雄州	xiongzhou
雅塘村	yatangcun
雅玛里克山	yamalikeshan
雅瑶	yayao
雅礼中学	yalizhongxue
雅荷花园	yahehuayuan
集庆门	jiqingmen
集源路	jiyuanlu
集贤街	jixianjie
集贤里	jixianli
雍华庭	yonghuating
雍和宫	yonghegong
雕塑公园	diaosugongyuan
雨花亭	yuhuating
雨花区政府	yuhuaquzhengfu
雨花周边	yuhuazhoubian
雨花新村	yuhuaxincun
雪乡	xuexiang
雪浪街道	xuelangjiedao
雷锋大道	leifengdadao
霁虹	jihong
震泽	zhenze
霍各庄	huogezhuang
霍德	huode
霍营	huoying
青云街	qingyunjie
青光	qingguang
青剑湖	qingjianhu
青园	qingyuan
青城山	qingchengshan
青塔	qingta
青山南路	qingshannanlu
青山湖大道	tangshan
青山路	qingshanlu
青岛大学	qingdaodaxue
青岛路	qingdaolu
青岩	qingyan
青年	qingnian
青年公园	qingniangongyuan
青年路	qingnianlu
青木关	qingmuguan
青林湾	qinglinwan
青果山	qingguoshan
青泥洼桥	qingni
青浦北部	qingpubeibu
青浦新城	qingpuxincheng
青秀山	qingxiushan
青羊小区	qingyangxiaoqu
青阳路	qingyanglu
青阳镇	qingyangzhen
青霞	qingxia
青龙路	qinglonglu
靖宇	jingyu
靖江路	jingjianglu
靖远路	jingyuanlu
静安寺	jingansi
静安新城	jinganxincheng
静观	jingguan
非矿	feikuang
革新	gexin
革镇堡	gezhenbao
鞍山	anshan
鞍山路	anshanlu
韦曲	weiqu
韩场	hanchang
韩家墩	hanjiadun
韩村河	hancunhe
韩森寨	hansenzhai
韭菜园	jiucaiyuan
韶存庄	shaocunzhuang
韶山中路	shaoshanzhonglu
韶山北路	shaoshanbeillu
韶山南路	shaoshannanlu
顶山	dingshan
顺和路	shunhelu
顺城街	shunchengjie
顺外路	hufang
顺德碧桂园	shundebiguiyuan
顺政路	shunzhenglu
顺通	shuntong
顾乡	gongnong
顾山镇	gushanzhen
顾村	gucun
颐中体育场	yizhongtiyuchang
颛桥	zhuanqiao
风雨坛	fengyutan
飞跃广场	feiyueguangchang
食品城	shipincheng
饮马街	yinmajie
馆驿街	guanyijie
首义路	shouyilu
首南	shounan
香坊大街	xiangfangdajie
香山	xiangshan
香店	xiangdian
香樟路	xiangzhanglu
香江路	xiangjianglu
香海小镇	xianghaixiaozhen
香海连天	xianghailiantian
香港东路	xianggangdonglu
香港中路	xianggangzhonglu
香港路	aomenluyinan
香炉礁	xianglujiao
香积寺路	xiangjisilu
香蜜湖	xiangmihu
马三家	masanjia
马乡	maxiang
马伸桥	mashenqiao
马喇	mala
马园	mayuan
马场	machang
马坊	mafang
马坡	mapo
马官桥	maguanqiao
马家	majia
马家堡	majiabao
马家店	majiadian
马家滩	majiatan
马巷	maxiang
马昌营	machangying
马栏	malan
马桥	maqiao
马武	mawu
马池口	machikou
马王	mawang
马王堆	mawangdui
马甸	madian
马群	maqun
马街	majie
马路湾	maluwan
马连洼	malianwa
马连道	xuanwumaliandao
马陆	malu
马鞍池	maanchi
马鞍路	maanlu
马驹桥	majuqiao
驰誉	chiyu
驷马桥	simaqiao
骆岗	luogang
骆驼	luotuo
骊山	lishan
高何	gaohe
高刘	gaoliu
高升小区	gaoshengxiaoqu
高升桥	gaoshengqiao
高叶塘	gaoyetang
高嘴	gaozui
高埂	gaogeng
高城山	gaochengshan
高塍镇	gaochengzhen
高塘	gaotang
高境	gaojing
高家庄	gaojiazhuang
高尔基路	gaoerjilu
高峰	gaofeng
高崖	gaoya
高新二路	gaoxinerlu
高新周边	gaoxinzhoubian
高新四路	gaoxinsilu
高新园区管委会	gaoxinyuanquguanweihui
高新开发区	gaoxinkaifaqu
高新路	gaoxinlu
高村	gaocun
高板	gaoban
高柱	gaozhu
高桥	gaoqiao
高梁	gaoliang
高水	gaoshui
高科园	gaokeyuan
高科花园	gaokehuayuan
高笋塘	gaosuntang
高营	gaoying
高行	gaohang
魁奇	kuiqi
魏公村	weigongcun
魏家坡	weijiapo
魏家庄	weijiazhuang
鱼儿沟	yuergou
鱼化寨	yuhuazhai
鱼嘴	yuzui
鱼洞	yudong
鱼珠	yuzhu
鱼窝头	yuwotou
鲁南花卉	lunanhuahui
鲁山道	lushandao
鲁巷	luxiang
鲁沙尔	lushaer
鲁班路	lubanlu
鲁谷	lugu
鲁迅公园	luxungongyuan
鲤中工业区	lizhonggongyequ
鲲鹏街	kunpengjie
鳌头	aotou
鳌峰	aofeng
鸡冠石	jiguanshi
鸳鸯	yuanyang
鸿城	hongcheng
鸿山镇	xinquhongshanzhen
鸿翔路	hongxianglu
鸿顺里	hongshunli
鹅池	echi
鹅湖	ehu
鹦鹉	yingwu
鹭江	lujiang
鹿乡	luxiang
鹿山	lushan
麒麟门	qilinmen
麓山名园	lushanmingyuan
麓谷	lugu
麦地	maidi
麦岛	maidao
麻丘	maqiu
麻园塘	mayuantang
麻柳嘴	maliuzui
麻柳沱	maliutuo
黄兴	huangxing
黄兴路	huangxinglu
黄务	huangwu
黄台南路	huangtainanlu
黄台路	huangtailu
黄土坡	huangtupo
黄土岭	huangtuling
黄埔区府	huangpuqufu
黄埔大道西	huangpudadaoxi
黄埭	huangdai
黄家寨	huangjiazhai
黄岐	huangqi
黄岗路	huangganglu
黄岳路口	huangyuelukou
黄巷	huangxiang
黄庄	baodihuangzhuang
黄忠	huangzhong
黄旗山	huangqishan
黄木岗	huangmugang
黄村	huangcun
黄松峪	huangsonggu
黄柏	huangbai
黄桥	huangqiao
黄桷坪	huangjueping
黄桷桠	huangjueya
黄水	huangshui
黄沙	huangsha
黄沙溪	huangshaxi
黄河	huanghe
黄河东路	huanghedonglu
黄河北	huanghebei
黄河市场	huangheshichang
黄河汽车站	huangheqichezhan
黄河路	huanghelu
黄河路以北	huangheluyibei
黄河道	huanghedao
黄泥川	huangnichuan
黄泥磅	huangnibang
黄洲	huangzhou
黄浦滨江	huangpubinjiang
黄海区域	huanghaiquyu
黄渡	huangdu
黄溪	huangxi
黄田坝	huangtianba
黄甲	huangjia
黄石	huangshi
黄花岗	huanghuagang
黄花店	huanghuadian
黄贝岭	huangbeiling
黄边	huangbian
黄阁	huangge
黄鹤楼	huanghelou
黄龙溪	huanglongxi
黎华小区	lihuaxiaoqu
黎明	liming
黎明路	liminglu
黎水	lishui
黑林铺	heilinpu
黑水路	heishuilu
黑溪	heixi
黑石渡	heishidu
黑石礁	heishijiao
黑虎泉西路	heihuquanxilu
黑龙江街	heilongjiang
黔灵东路	qianlingdonglu
鼓东	gudong
鼓山	gushan
鼓楼巷	gulouxiang
鼓楼片区	zhuji
鼓浪屿	gulangyu
鼓西	guxi
齐礼阎	qiliyan
齐贤	qixian
齐鲁软件园	qiluruanjianyuan
龙丰、上排、红花湖	longfengshangpaihonghuahu
龙仁	longren
龙兴	longxing
龙凤桥	longfengqiao
龙凤苑	longfengyuan
龙口东	longkoudong
龙口西	longkouxi
龙塘	longtang
龙头寺	longtousi
龙岗中心城	longgangzhongxincheng
龙归	longgui
龙柏金汇	longbojinhui
龙桥	longqiao
龙池	longchi
龙河	longhe
龙泉路	longquanlu
龙泽	longze
龙洞	longdong
龙洞堡	longdongbao
龙津	longjin
龙溪	longxi
龙滩子	longtanzi
龙潭	longtan
龙潭公园	longtangongyuan
龙潭湖	longtanhu
龙潭路	longtanlu
龙王塘	longwangtang
龙珠花园	longzhuhuayuan
龙翔	longxiang
龙舟路	longzhoulu
龙西	longxi
龙都	longdu
龙门山	longmenshan
龙门浩	longmenhao
龙首村	longshoucun
龙驹	longju
龚家寨	gongjiazhai
龚家湾	gongjiawan
