东钱湖	dongqianhu
江南西	jiangnanxi
民康路	minkang
合家福购物街	hejiafugouwujie
罗家	luojia
尼玛江热	nimajiangre
拦隆口	lanlongkou
成才路	chengcailu
渭源路	weiyuanlu
赤岗岭	chigangling
冉义	ranyi
左家庄	zuojiazhuang
南湖广场	nanhuguangchang
桂花路口	guihualukou
中华路	zhonghualu
无影山	wuyingshan
长江批发市场	changjiangpifashichang
费家营	feijiaying
红星街	hongxingjie
诗书	shishu
黄河北	huanghebei
宝龙广场	baolongguangchang
徐家汇	xujiahui
开阳路	kaiyanglu
韶山中路	shaoshanzhonglu
解放西路	jiefangxilu
沙园	shayuan
东夷大街	dongyidajie
童家溪	tongjiaxi
上南新村	shangnanxincun
草庙子	caomiaozi
七里海	qilihai
大孤家子	dagujiazi
郭巷	guoxiang
寨上	zhaishang
辽源路	liaoyuanlu
刘二堡	liuerpu
环市中	huanshizhong
洪桥	hongqiao
延长路	yanchanglu
姜戈庄	jianggezhuang
并州东西街	bingzhoudongxijie
玉祥门	yuxiangmen
滠口	shekou
红石崖	hongshiya
首南	shounan
锡沪路	xihulu
迈皋桥	maigaoqiao
金坛路	jintanlu
百丈	baizhang
丰庆路	fengqinglu
佳农市场	jianongshichang
良王庄	liangwangzhuang
共济	gongji
机场路	jichanglu
新街街道	xinjiejiedao
无影山东路	wuyingshandonglu
凤宾路	fengbinlu
百济	baiji
五一大道	wuyidadao
酒店	jiudian
堰桥街道	yanqiaojiedao
官园	guanyuan
省展览馆	shengzhanlanguan
通济	tongji
南岭	nanling
马武	mawu
月苑	yueyuan
成渝立交	chengyulijiao
济齐路西段	jiqiluxiduan
红旗街	hongqi
大学城	daxuecheng
七里塘	qilitang
皓月大路	haoyuedalu
商务内环	shangwuneihuan
峡口	xiakou
平房镇	pingfangzhen
台头	taitou
涂山	tushan
棠下	tangxia
清河南路	qinghenanlu
洪都	hongdou
皋兰路	gaolanlu
芙蓉广场	furongguangchang
植物园	zhiwuyuan
南菜园	nancaiyuan
百盛滨海广场	baishengbinhaiguangchang
王卜庄	wangbozhuang
龙柏金汇	longbojinhui
北岭	beiling
民治	minzhi
廉庄	lianzhuang
新桥镇	xinqiaozhen
华强北	huaqiangbei
月浦	yuepu
文政	wenzheng
松浦	songpu
八卦洲	baguazhou
华山镇	huashanzhen
虎踞路	hujulu
仙葫经济开发区	xianhujingjikaifaqu
青浦新城	qingpuxincheng
夏庄	xiazhuang
白纸坊	baizhifang
江东花园	jiangdonghuayuan
大经街	donghua
对青山	duiqingshan
炮台	paotai
卢沟桥	lugouqiao
迎龙	yinglong
集贤街	jixianjie
淮口	huaikou
桥梓	qiaoxin
中东大市场	zhongdongdashichang
郑州路	zhengzhoulu
晋城	jincheng
上下桥	shangxiaqiao
加洲新牌坊	jiazhouxinpaifang
荣华	ronghua
熊儿寨	xiongerzhai
滑翔小区	huaxiang
黄兴路	huangxinglu
启阳路	qiyanglu
国展	guozhan
辽河街	liaohe
小街	xiaojie
水师营	shuishiying
塘沽新村街	tangguxincunjie
广安门	guanganmen
增福	zengfu
航空港	hangkonggang
十里铺	shilipu
秦陵	qinling
象园	xiangyuan
百佳	baijia
北园路	beiyuanlu
中峰	zhongfeng
坛洛镇	tanluozhen
拉康	lakang
迎新路	yingxinlu
中南路	zhongnanlu
联盟	lianmeng
新民场	xinminchang
大纺	dafang
汽车西站	qichexizhan
建北	jianbei
中医附院	zhongyifuyuan
淮河西路	huaihexilu
泉秀	quanxiu
海府	haifu
凤城四路	fengchengsilu
金马路	jinmalu
下沙	xiasha
爱工街	aigongjie
站前西路	zhanqianxilu
武宁路	wuninglu
全福	quanfu
万宝	wanbao
银湖路	yinhulu
韩村河	hancunhe
新建街	xinjianjie
三溪	sanxi
SM附近	smfujin
长桥	changqiao
成丰桥	chengfengqiao
南山医院	nanshanyiyuan
四道街	sidaojie
双环村	shuanghuancun
万达广场	wandaguangchang
岳阳	yueyang
南湖北路	nanhubeilu
小津桥	xiaojinqiao
吴家山	wujiashan
西坞	xiwu
挹江门	yijiangmen
泥城	nicheng
三台子	santaizi
市三医院	shisanyiyuan
采荷	caihe
土顶	tuding
新国展	xinguozhan
李家山	lijiashan
乔庄	qiaozhuang
河埒	helie
长青	zhangqing
唐家墩	tangjiadun
安德门	andemen
良田	liangtian
二戈寨	ergezhai
鼓楼片区	zhuji
制锦市	zhijinshi
义井	yijing
黄河市场	huangheshichang
攸攸板	youyouban
和田	hetian
潍柴	weichai
代王	daiwang
杨和	yanghe
小鱼洞	xiaoyudong
交大路	jiaodalu
里水	lishuiqu
雕塑公园	diaosugongyuan
21世纪花园	21shijihuayuan
县府街	xianfujie
东盛	dongsheng
东南	dongnan
珠吉	zhuji
卓刀泉	zhuodaoquan
达嘎	daga
开元	kaiyuan
竹山路	zhushanlu
大沙头	dashatou
鸿翔路	hongxianglu
岳各庄	yuegezhuang
天河公园	tianhegongyuan
濯水	zhuoshui
卫生路	weishenglu
浦沅	puyuan
家电城	jiadiancheng
重固	zhonggu
临江	linjiang
王家巷	wangjiaxiang
燕尔窝	yanerwo
芷江西路	zhijiangxilu
教化	jiaohua
羊八井	yangbajing
清水塘	qingshuitang
造甲城	zaojiacheng
猴子石	houzishi
水佐岗	shuizuogang
火炼树	huolianshu
元通	yuantong
沙滩	shatan
茶园	chayuan
黄边	huangbian
奉城	fengcheng
朱家房	zhujiafang
张江	zhangjiang
徐舍镇	xushezhen
新阳路	anhe
习岗	xigang
慈城	cicheng
天马山	tianmashan
三林	sanlin
小西	xiaoxi
老瓜堡	laoguabao
城镇	chengzhen
冯庄	fengzhuang
解放北路	jiefangbeilu
提篮桥	tilanqiao
丰泽街道	fengzejiedao
杏西路	xingxilu
芦苞	lubao
白果林	baiguolin
玉村	yucun
城北版块	chengbeibankuai
陈家湾	chenjiawan
闽江大道	minjiangdadao
永叔路	yongshulu
西安桥外	xianqiaowai
黄家寨	huangjiazhai
大榭	daxie
高板	gaoban
江阳工业园	jiangyanggongyeyuan
邦均	bangjun
三经路	sanjinglu
梦泽园	mengzeyuan
主山	zhushan
梅花村	meihuacun
人民广场西	renminguangchangxi
江川路	jiangchuanlu
延安中路	yananzhonglu
西红门	xihongmen
方兴	fangxing
青阳路	qingyanglu
六里山	liulishan
马驹桥	majuqiao
西三道街	xisandaojie
崮山	gushan
东马圈	dongmaquan
弼塘	bitang
船舶	chuanbo
流亭	liuting
绿景	lvjing
漕泾	caojing
城桥	chengqiao
漆桥	qiqiao
大柏树	dabaishu
三墩	sandun
通河西城区	tonghexichengqu
北温泉	beiwenquan
小东	xiaodong
烈士公园	lieshigongyuan
江滨中路	jiangbinzhonglu
虎石台	hushitai
桐梓坡路	tongxinpolu
竹公溪	zhugongxi
汽贸城	qimaocheng
抚松路	fusonglu
羊马	yangma
宝岗	baogang
岗厦	gangsha
排尾路	paiweilu
自由大路	ziyoudalu
五泉广场	wuquangguangchang
红莲	honglian
白果	baiguo
西朝阳路	xichaoyanglu
拱星墩	gongxingdun
蒋巷	jiangxiang
长安街道	changanjiedao
杨成庄	yangchengzhuang
龙溪	longxi
东三街	dongsanjie
兴关	xingguan
观沙岭	guanshaling
民族广场	minzuguangchang
石钟	shizhong
黄河	huanghe
朗霞	langxia
石葵路	shikuilu
吉崩岗	jibenggang
省人大	shengrenda
亲贤	qinxian
小城子	xiaochengzi
兴谷	xinggu
银雀山路	yinqueshanlu
葛沽	gegu
穗东	suidong
经济技术开发区	jingjijishukaifaqu
广州路	guangzhoulu
义和路	yihelu
豫章	yuzhang
莲花山	lianhuashan
济微路	jiweilu
施家梁	shijialiang
二里庄	erlizhuang
安国街	anjing
春柳	chunliu
福升	fusheng
天鹅饭店	tianefandian
黄埔大道西	huangpudadaoxi
九江	jiujiang
溪之谷	xizhigu
风雨坛	fengyutan
海垦	haiken
京广路	jingguanglu
建安	jianan
铁东路	tiedonglu
邻海园	linhaiyuan
中新	zhongxin
兴汉门	xinghanmen
郫筒	pitong
白杨	baiyang
师范路	shifanlu
江头	jiangtou
静安寺	jingansi
中兴	zhongxing
旧街	jiujie
八门城	bamencheng
坎墩	kandun
黑虎泉西路	heihuquanxilu
建设路	jianshelu
磨子桥	moziqiao
红枫湖	hongfenghu
下瓦房	xiawafang
桃仙	taoxian
马家店	majiadian
回兴	huixing
李家	lijia
军粮城	junliangcheng
辛家庙	xinjiamiao
下伍旗	xiawuqi
十四纬路	shisiweilu
崇华路	chonghualu
澳门路	aomenlu
佘山	sheshan
隆兴	longxing
安亭	anting
汪集	wangji
西青周边	xiqingzhoubian
陈寨	chenzhai
江湾	jiangwan
曹路	caolu
宦溪	huanxi
湖南路	hunanlu
雷锋大道	leifengdadao
和凤	hefeng
望远	wangyuan
政府广场	zhengfuguangchang
密云路	miyunlu
中马	zhongma
元疃	yuantuan
华通	huatong
白沙路	baishalu
金柱园	jinzhuyuan
引镇	yinzhen
花园路	guanchenghuizuhuayuanlu
双桥河	shuangqiaohe
张强	zhangqiang
跃进路	yuejin
松霞路	songxialu
春江	chunjiang
体育南大街	tiyunandajie
北安路	beianlu
长生桥	zhangshengqiao
东郊	dongjiao
小淀	xiaodian
张公岭	zhanggongling
台西	taixi
东焦	dongjiao
闸北公园	zhabeigongyuan
段家滩	duanjiatan
孝陵卫	xiaolingwei
山屏街	shanpingjie
革镇堡	gezhenbao
上钢新村	shanggangxincun
花园桥	huayuanqiao
体育场	tiyuchang
幽兰	youlan
松陵	songling
东北街	dongbeijie
凯瑞园	kairuiyuan
南极市场	nanjishichang
前卫	qianwei
上杭路	shanghanglu
五桂桥	baohe
宣武门	xuanwumen
府青路	fuqinglu
西二环	xierhuan
连江路	lianjianglu
新添寨	xintianzhai
沙门	shamen
中大	zhongda
荔枝沟	lizhigou
上社	shangshe
神仙树	shenxianshu
下窝头	xiawotou
岭南	lingnan
中山西路	zhongshanxilu
造化	zaohua
西南科技大学	xinankejidaxue
同光路	tongguanglu
翠苑	cuiyuan
电大街	diandajie
槐底	huaidi
旱西关	hanxiguan
集源路	jiyuanlu
五四北	wusibei
天星桥	tianxingqiao
大南	danan
开福周边	kaifuzhoubian
大芬村	dafencun
白水井	baishuijing
天河南	tianhenan
同德路	tongdelu
其奴	qinu
宝华街	baohuajie
方家庄	fangjiazhuang
东街	dongjie
公塘	gongtang
新开路	xinkailu
麻柳嘴	maliuzui
铁峰	tiefeng
肇工街	zhaogongjie
上沙	shangsha
西华路	xihualu
沙太南	shatainan
浮山新区	fushanxinqu
工程街	gongcheng
尔王庄	erwangzhuang
马陆	malu
九尺	jiuchi
西苑	xiyuan
秀水河子	xiushuihezi
枫桥	fengqiao
九池	jiuchi
文城区	wencheng
白鹿	bailu
中上虞	zhongshangyu
北山门	beishanmen
海尔路	haierlu
百万庄	baiwanzhuang
洛溪	luoxi
体育北大街	tiyubeidajie
新华桥	xinhuaqiao
黄巷	huangxiang
临册路	lincelu
联合	lianhe
青云街	qingyunjie
纳木湖	namuhu
水屯北路	shuitunbeilu
广电大厦	guangdiandasha
小枧	xiaojian
世昌大道	shichangdadao
水碓子	shuiduizi
七里山	qilishan
树勋街	shuxunjie
罗店	luodian
黄岳路口	huangyuelukou
城北街道	chengbeijiedao
鲁巷	luxiang
九三路	jiusanlu
西坝河	xibahe
二台子	ertaizi
花牌坊	huapaifang
振头	zhentou
南关岭	nanguanling
晶桥	jingqiao
八大峡	badaxia
大润发	darunfa
真新新村	zhenxinxincun
大发	xinhua
绳金塔	shengjinta
东大桥	dongdaqiao
辛寨子	xinzhaizi
城子街道	chengzijiedao
西安路	xianlu
凤凰大街	fenghuangdajie
临沂九中	linyijiuzhong
衡山路	hengshanlu
三郎	sanlang
三马路	sanmalu
中华南大街	zhonghuanandajie
方庙	fangmiao
焦石	jiaoshi
动物园	dongwuyuan
叠山路	dieshanlu
友谊街口	youyijiekou
南阳路	nanyanglu
重沟	chonggou
普庆路	puqinglu
华岩	huayan
王哥庄	wanggezhuang
农科院	nongkeyuan
溧水县农场	lishuixiannongchang
张关	zhangguan
南二环路	nanerhuanlu
乌拉泊	wulabo
松岗	songgang
新山村	xinshancun
芙蓉区政府	furongquzhengfu
斯大林路	sidalinlu
独树村	dushucun
杨公	yanggong
双龙大道	shuanglongdadao
石佛营	shifoying
布吉关	bujiguan
二工	ergong
光谷大街	guanggudajie
江海街道	jianghaijiedao
长兴岛	changxingdao
华阳	huayang
人民大街	renmindajie
平政	pingzheng
文家	wenjia
詹家溪	zhanjiaxi
蔡锷南路口	caienanlukou
酒泉路	jiuquanlu
万通	wantong
奥帆基地	aofanjidi
江汉二桥	jianghanerqiao
松江大学城	songjiangdaxuecheng
天化	tianhua
鱼珠	yuzhu
长白街	changbaijie
星海湾	xinghaiwan
营城子	yingchengzi
康平街	kangpingjie
台北路	taibei
沙东	shadong
水碾河	shuijingfang
东盟商务区	dongmengshangwuqu
城南	chengnan
旧大桥	jiudaqiao
花园新村	huayuanxincun
东五路	dongwulu
渡	rangdu
经一路	jingyilu
兴顺	xingshun
淮海中路	huaihaizhonglu
三店	dongxihusandian
桂花坪	guihuaping
北桥	beiqiao
金顶街	jindingjie
麒麟门	qilinmen
南京街	nanjingjie
罗庄医院	luozhuangyiyuan
娄门	loumen
港门村	gangmencun
南磨房	nanmofang
迎龙桥	yinglongqiao
三电	sandian
星海公园	xinghaigongyuan
金花路	jinhualu
龙归	longgui
地段街	zhaolin
拉木	lamu
北山	beishan
昌岗	changgang
五宝	wubao
文昌门	wenchangmen
八里桥	baliqiao
信河街 	xinhejie
梁头	liangtou
南大街	nandajie
西京大学	xijingdaxue
家具城	qilu
王官庄	wangguanzhuang
康复路	kangfulu
春光街	chunguangjie
太升路	taishenglu
七星楼	qixinglou
二七北路	erqibeilu
潍坊	weifang
富士康	fushikang
仙海镇	xianhaizhen
禾山	heshan
莫干山路	moganshanlu
钢都	hongweilu
建胜	jiansheng
澳头	aotou
汤河口	tanghekou
东部市立医院	dongbushiliyiyuan
中润华侨城	zhongrunhuaqiaocheng
三涧堡	sanjianbao
灵塔	lingta
龙王塘	longwangtang
韩场	hanchang
白云大道南	baiyundadaonan
松山小区	songshanxiaoqu
龙仁	longren
小南	xiaonan
金宇	jinyu
大口屯	dakoutun
对湖	duihu
天回	tianhui
五道口	wudaokou
安宁西路	anningxilu
两路口	lianglukou
赤坭	chini
大北	dabei
彭埠	pengbu
大学西路	daxuexilu
锦绣江南	jinxiujiangnan
新沟	xingou
泊于	boyu
荣光	rongguang
雨花周边	yuhuazhoubian
岳阳街	yueyangjie
华景新城	huajingxincheng
南湖花园	nanhuhuayuan
鹦鹉	yingwu
三和街	sanhejie
二中	erzhong
安宁渠	anningqu
汤山	tangshan
太阳城	taiyangcheng
银滩	yintan
许府巷	xufuxiang
龙西	longxi
小岛花园	xiaodaohuayuan
越秀路	yuexiulu
梅山	meishan
文新	wenxin
普吉	puji
南外滩	nanwaitan
望龙门	wanglongmen
沂州路	yizhoulu
哈药路	zhengyanghe
陶吴镇	taowuzhen
新华西路	xinhuaxilu
航头	hangtou
班觉林	banjiaolin
兰陵	lanling
天地广场	tiandiguangchang
石马河	shimahe
七贤岭	qixianling
杨汊湖	yangchahu
北仲路	beizhonglu
白头	baitou
安庆路	anqinglu
南羊	nanyang
京口路	jingkoulu
浏阳河路	liuyanghelu
大孟庄	damengzhuang
庞各庄	panggezhuang
香樟路	xiangzhanglu
曹子里	caozili
北辰周边	beichenzhoubian
朱巷	zhuxiang
东太康路	dongtaikanglu
白土	wanzhoubaitu
高新路	gaoxinlu
大窑湾	dayaowan
东瓜山/赤岭路	dongguashan
沙面	shamian
翠月湖	cuiyuehu
古城建政区	guchengjianzhengqu
浣花小区	huanhua
玉函路	yuhanlu
天府广场	xiyuhe
台湾街	taiwanjie
南纬路	nanweilu
芜湖路	wuhulu
汝河路	ruhelu
新阳	xinyang
磁器口	ciqikou
彩虹	caihong
海辉街	haihuijie
邵公庄	shaogongzhuang
堤北	dibei
北关环岛	beiguanhuandao
袁家岭	yuanjialing
泉河	quanhe
甘露园	ganluyuan
李渡	lidu
半淞园路	bansongyuanlu
丽春	lichun
月川路	yuechuanlu
上园路	shangyuan
红梅北环	hongmeibeihuan
万年场	wannianchang
上甘	shanggan
昌平县城	changpingxiancheng
唐昌	tangchang
延安	yanan
木樨园	muxiyuan
南码头	nanmatou
清波	qingbo
立水桥	lishuiqiao
新华公园	xinhuagongyuan
回龙	huilong
鱼洞	yudong
北站路	beizhanlu
九龙坡周边	jiulongpozhoubian
巨轮	julun
横沙岛	hengshadao
百花井	baihuajing
环城北路	huanchengbeilu
建中街	jianzhonglu
高崖	gaoya
砂山	shakou
黑溪	heixi
三里亭	sanliting
岳峰	yuefeng
渝北周边	yubeizhoubian
珠江路	zhujianglu
燕莎	yansha
长坪	zhangping
椒金山	jiaojinshan
三条石	santiaoshi
桂溪	guixi
盛岸路	shenganlu
黄鹤楼	huanghelou
接龙	jielong
二圣	ersheng
刘家窑	liujiayao
前川	qianchuan
机场西路	jichangxilu
高科园	gaokeyuan
春华路	chunhualu
哈站	hazhan
紫荆	zijing
三里屯	sanlitun
河东周边	hedongzhoubian
扬子洲	yangzizhou
西南路	xinanlu
天穆	tianmu
凤凰山	fenghuangshan
五山	wushan
同集南路	tongjinanlu
和兴路	hexing
米市巷	mishixiang
武胜路	wushenglu
长辛店	changxindian
冯三	fengsan
坞城	wucheng
顾山镇	gushanzhen
现代广场	xiandaiguangchang
宜兴埠	yixingbu
堡镇	baozhen
临湖	linhu
玄坛庙	xuantanmiao
航华	hanghualongbai
孙家疃	sunjiatuan
刘家店	liujiadian
仙霞岭路	xianxialinglu
西四道街	xisidaojie
工农大路	gongnongdalu
大兴乡	daxingxiang
公路大桥	gongludaqiao
安泰	antai
旧州	jiuzhou
良乡	liangxiang
解放门	jiefangmen
浦上大道	pushangdadao
大沙田	dashatian
大同街	datongjie
八王寺	bawangsi
霁虹	jihong
靖宇	jingyu
昌华	changhua
天平架	tianpingjia
不老屯	bulaotun
白沙岭	baishaling
惠南	huinan
定福庄	dingfuzhuang
文昌路	wenchanglu
红星美凯龙	hongxingmeikailong
南城区	nanchengqu
宗汉	zonghan
环城西路	huanchengxilu
江滨东大道	jiangbindongdadao
中心区	futianzhongxinqu
南山镇	nanshanzhen
朱雀大街	zhuquedajie
文锦	wenjin
车管所	cheguansuo
枫树岭	fengshuling
西一路	xiyilu
古荣	gurong
岗顶	gangding
航海西路	hanghaixilu
寺寨	sizhai
漕河	caohe
西桥路	xiqiaolu
小红门	xiaohongmen
孙家沟	sunjiagou
次渠	ciqu
沙渠	shaqu
文教	wenjiao
老虎滩	hutan
市火车站	shihuochezhan
建设北大街	jianshebeidajie
樱驼花园	yingtuohuayuan
丰收路	fengshoulu
紫坪铺	zipingpu
六里桥	liuliqiao
啤酒街	pijiujie
哲里木路	zhelimulu
桑园	sangyuan
桂花村	guihuacun
中山南街	zhongshannanjie
环岛公园	huandaogongyuan
湘雅路	xiangyalu
葑门	fengmen
山东庙	shandongmiao
望月湖	wangyuehu
天津路	tianjinlu
旅顺开发区	lvshunkaifaqu
望江路	wangjianglu
大福源	dafuyuan
红岩	hongyan
军屯	juntun
五一广场	wuyiguangchang
玉林	yulin
改布	gaibu
乌玛塘	wumatang
金石滩	jinshitan
行者	hangzhe
临河街	linhejie
五一南路	wuyinanlu
王家坡	wangjiapo
文景路	wenjinglu
环河街	huanhejie
六一南路	liuyinanlu
云峰	yunfeng
龙珠花园	longzhuhuayuan
五块石	wukuaishi
左家垅	zhuojialong
望亭	wangting
崇兴	chongxing
五棵松	wukesong
矿市	kuangshi
江源	jiangyuan
华夏路	huaxialu
金沟寨	jingouzhai
遵义路	zunyilu
太古	taigu
新安西路	xinanxilu
高尔基路	gaoerjilu
洋中	yangzhong
王家沟	wangjiagou
亚美大厦	yameidasha
沿海经济开发区	yanhaijingjikaifaqu
北七家	beiqijia
海幢	haizhuang
趵突泉北路	zhonggongbaotuquanbeilu
水集	shuiji
长乐西路	changlexilu
匡远	kuangyuan
火车站	huochezhan
3536	3536
普阳街	puyang
湘雅医院	xiangyayiyuan
长久路	changjiulu
七宝	qibao
街道口	jiedaokou
安盛	ansheng
抚琴	fuqin
和平东路	hepingdonglu
咸阳北路	xianyangbeilu
学府	baojian
西门口	ximenkou
东孚	dongfu
进乡街	jinxiang
兴寿	xingshou
宁园	ningyuan
鱼窝头	yuwotou
席王	xiwang
奎园	kuiyuan
禄口	lukou
金源小区	jinyuanxiaoqu
石佛镇	shifozhen
明光路	mingguanglu
海浴路	haiyulu
鲤中工业区	lizhonggongyequ
祝华	zhuhua
人和	renhe
兴宁区政府	xingningquzhengfu
田家寨	tianjiazhai
复兴	fuxing
东沟岭	donglinggou
柏庄	baizhuang
北大街街道	beidajiejiedao
莲前	lianqian
七七街	qiqijie
苏州街	suzhoujie
九眼桥	jiuyanqiao
翠竹	cuizhu
沙洲	shazhou
宜城街道	yichengjiedao
东方红大桥	dongfanghongdaqiao
亦庄	yizhuang
文艺路	wenyilu
北岗桥	beigangqiao
鳌峰	aofeng
寿春	shouchun
南门	nanmen
公滨路	xincheng
白沙	baisha
阿尔泰游乐园	aertaiyouleyuan
刘长山路	liuchangshanlu
上派	shangpai
朝晖	zhaohui
新江	xinjiang
狗街	goujie
库充	kuchong
新疆	xinjiang
南禅寺	nanchansi
福利路	fulilu
工业南路	gongyenanlu
十八里店	shibalidian
青园	qingyuan
裕强	yuqiang
武昌街	wuchangjie
高家庄	gaojiazhuang
江高	jianggao
贵乌路	guiniaolu
七里岗	qiligang
五泉	wuquan
汉正	hanzheng
周铁镇	zhoutiezhen
匡山	kuangshan
秀月街	xiuyuejie
小西门	xiaoximen
敦煌路	dunhuanglu
莲花北村	lianhuabeicun
建桥	jianqiao
盘旋路	panxuanlu
月牙湖	yueyahu
中曹	zhongcao
果园	guoyuan
吞巴	tunba
更楼	genglou
分水	fenshui
湘江中路	xiangjiangzhonglu
白湖亭	baihuting
大坪	daping
宅吉	zhaiji
大召	dazhao
张公桥	zhanggongqiao
石鼻	shibi
天河路	tianhelu
经纬街	jingwei
石泉路	shiquanlu
登峰	dengfeng
苏苑	suyuan
观胜	guansheng
西北旺	xibeiwang
临港新城	lingangxincheng
中医学院	zhongyixueyuan
水塔	shuita
信息大厦	xinxidaxia
九里堤	jiulidi
月牙河	yueyahe
甘河滩	ganhetan
旺座现代城	wangzuoxiandaicheng
莲桂路	guilianlu
淞南	songnan
七星岗	qixinggang
环秀	huanxiu
劳动公园	laodonggongyuan
人民路立交桥	renminlulijiaoqiao
西三庄	xisanzhuang
民丰里	minfengli
丹西	danxi
外高桥	waigaoqiao
梅林	meilin
沙井驿	shajingyi
沙头角	shatoujiao
五三	wusan
三叉街	sanchajie
昆明机场	kunmingjichang
三牌楼	sanpailou
陇海西路	longhaixilu
金口	jinkou
红旗大街	hongqidajie
长兴路	changxinglu
尚志大街	daolishangzhi
大坡	dapo
大铺	dapu
景阳广场	jingyangguangchang
豆各庄	dougezhuang
良渚	liangzhu
大宁路	daninglu
石子冲	shizichong
萧王庙	xiaowangmiao
塘桥	tangqiao
真光新村	zhenguangxincun
泰来街	nanhutailaijie
马伸桥	mashenqiao
历山路	lishanlu
学府街	xuefu
大方里	dafangli
北大学城	beidaxuecheng
铜陵路	tonglinglu
郑汴路	zhengbianlu
岗店	gangdian
车站大道	chezhandadao
罗六路	luoliulu
穆家峪	mujiayu
付家庄	fujiazhuang
粤垦	yueken
四方长途站	sifangchangtuzhan
闵子骞路	minziqianlu
东软	dongruan
科技四路西段	kejisiluxiduan
俚岛	lidao
强嘎	qiangga
经三路	jingsanlu
中专路	zhongzhuanlu
广宜街	zhujianlu
贤士二路	xianshierlu
四牌楼	baohegongyuan
黄浦滨江	huangpubinjiang
茶亭	chating
雨花新村	yuhuaxincun
金山新城	jinshanxincheng
白马山	baimashan
泺源大街	luoyuandajie
许家台	xujiatai
杨家滩	yangjiatan
铁北	tiebei
塘加	tangjia
渭塘	weitang
东昌站地铁	dongchangzhanditie
临洮街	lintaojie
工业大学	gongyedaxue
朝阳洲	chaoyangzhou
西彭	xipeng
兰亭路	lantinglu
颛桥	zhuanqiao
天彭	tianpeng
管南片	guannanpian
四平路	yangpusipinglu
正果	zhengguo
花水湾	huashuiwan
和煦园	hexuyuan
弹子石	danzishi
南门路	nanmenlu
瑶琳	yaolin
杨东	yangdong
岳林	yuelin
东棘坨	dongjituo
万向汽车城	wanxiangqichecheng
大东路	dalonglu
西山驿	xishanyi
东泉	dongquan
羲之路	xizhilu
职工新村	zhigongxincun
西沽	xigu
马坊	mafang
西康路	xikanglu
丰台路	fengtailu
彩田村	caitiancun
岳龙	yuelong
行政中心	xingzhengzhongxin
海阳所	haiyangsuo
白马南路	baimananlu
上新庄	shangxinzhuang
荷包湖	hebaohu
民生路	minshenglu
砂子塘	yuhuashazitang
百合山庄	baiheshanzhuang
棉纺路	mianfanglu
史各庄	baodishigezhuang
礼让街	lirangjie
陆家嘴	lujiazui
西罗园	xiluoyuan
凌水	lingshui
上马台	shangmatai
柳街	liujie
明湖北路	minghubeilu
冉屯路	rantunlu
光华街	guanghuajie
常青花园	changqinghuayuan
董家湾	dongjiawan
静观	jingguan
沂蒙八路	yimengbalu
孟寨	mengzhai
汤池	tangchi
五津	wujin
中梁山	jiulongpozhongliangshan
丁家房	dingjiafang
利港镇	ligangzhen
菜户营	caihuying
上下九	shangxiajiu
山东路家乐福	shandonglujialefu
柳巷	liuxiang
华城路	huachenglu
颐中体育场	yizhongtiyuchang
井岸	jingan
太师屯	taishitun
华大	huada
金山卫	jinshanwei
牛市口	niushikou
千灯湖	qiandenghu
柏泉	baiquan
文一路	wenyilu
广开街	guangkai
凤凰山路	fenghuangshanlu
周家坝	zhoujiaba
胜利桥	shengliqiao
马甸	madian
裕兴	yuxing
东葛路	donggelu
西京医院	xijingyiyuan
陵西	huanggulingxi
百鸟公园	bainiaogongyuan
静安新城	jinganxincheng
东风路	dongfenglu
深圳路	shenzhenlu
翟营大街	zhaiyingdajie
净月镇	jingyuezhen
蒋家垅	jiangjialong
六一北路	liuyibeilu
赛虹桥	saihongqiao
扬名街道	yangmingjiedao
高嘴	gaozui
滢水山庄	yingshuishanzhuang
蓬莱公园	penglaigongyuan
东五里	dongwuli
L山	zhashan
中山亭	zhongshanting
南坛下埔	nantanxiapu
建设七路	jiansheqilu
猎德	liede
经八路	guanchenghuizujingbalu
刘寨	liuzhaipian
善化路	shanhualu
铁百	tiebai
山东路	shandonglu
城南新区	chengnanxinqu
罗庄子	luozhuangzi
新星小区	xinxingxiaoqu
工业大道北	gongyedadaobei
头桥	touqiao
致民路	zhiminlu
金刀峡	jindaoxia
万泉河	wanquanhe
华林	hualin
饮马街	yinmajie
天台山	tiantaishan
李桥	liqiao
金碧片区	jinbi
人民北路	renminbeilu
燕山	yanshan
浮山路	fushanlu
小窑湾	xiaoyaowan
新起屯	xinqitun
镇宁路	zhenninglu
沃尔玛	woerma
黄渡	huangdu
朝阳街	chaoyangjie
朝青板块	chaoqingbankuai
马官桥	maguanqiao
东大直街	rongshi
天成路	tianchenglu
双山	shuangshan
册山	ceshan
三星	shuangliusanxing
小市	xiaoshi
嘉兴路	jiaxinglu
塔头	tatou
演达片区	yandapianqu
东木头市	dongmutoushi
街口	jiekou
石埠	shibu
石沟屯	shigoutun
浒墅关	xushuguan
荷城	hecheng
鲁沙尔	lushaer
翔运街	xiangyunjie
西中华路	xizhonghualu
方松	fangsong
轴承厂	zhouchengchang
扎西岗	zhaxigang
晓港	xiaogang
县坝	xianba
椒房	jiaofang
苹果园	pingguoyuan
紫荆山路	zijingshanlu
铜元局	tongyuanju
一经	yijing
六指店	liuzhidian
展览路	zhanlanlu
光华路	guanghualu
八佰伴	babaiban
沙正街	shazhengjie
汇通路	huitonglu
钟鼓楼	zhonggulou
麓山名园	lushanmingyuan
中涧河	zhongjianhe
八宝街	babaojie
威清路	weiqinglu
十里岗	shiligang
吟月桥	yinyueqiao
魏家庄	weijiazhuang
切玛	qiema
秦虹	qinhong
山大北路	shandabeilu
灵隐	lingyin
昆山路	kunshan
琶洲	pazhou
苗圃	miaopu
沂蒙七路	yimengqilu
八一	bayi
南星	nanxing
菜艺街	liushun
沿东	yandong
大佛段	dafoduan
奥体	aoti
塔湾	tawan
北下街	beixiajie
冯家坝	fengjiaba
第四大街	disidajie
王家垅	wangjialong
浑河站西	hunhezhanxi
深大北门	shendabeimen
通达路	tongdalu
沙庄	shazhuang
浆水泉路	jiangshuiquanlu
北坦街	beitanjie
青羊小区	qingyangxiaoqu
三店西路	sanjiadian
段店	duandian
兴华	xinghua
石湫	shiqiu
璜土镇	huangtuzhen
但渡	dandu
趵突泉	baotuquan
闽江路	minjianglu
黔灵东路	qianlingdonglu
泰华	taihua
孙村	suncun
钢花村	ganghuacun
长湖路	changhulu
李村	licun
方村	fangcun
南京东路	nanjingdonglu
寸滩	cuntan
电视塔	dianshita
东峡	datongzizhixiandongxia
机研所	jiyansuo
龚家寨	gongjiazhai
琴断口	qinduankou
寺儿沟	siergou
木樨地	muxidi
宏伟路	dayoufang
珠林	zhulin
水荫路	shuiyinlu
安东街	andongjie
朝天宫	chaotiangong
河南庄	henanzhuang
牌楼	pailou
万佳	wanjia
玉凤路	yufenglu
太白南路	taibainanlu
万家	wanjia
跃进街	yuejinjie
崖西	yaxi
松江工业区	songjianggongyequ
新天地	xintiande
阅江楼	minjianglou
珠海路	zhuhailu
普明	puming
车道沟	chedaogou
安靖	anjing
胜太路	shengtailu
大林	dalin
赣水路	ganshuilu
东财	dongcai
潘庄	panzhuang
香江路	xiangjianglu
葵巷	kuixiang
淡水	danshui
水湖	shuihu
华信路	huaxinlu
大沥	dalijd
大西街	daxijie
东晓	dongxiao
玉堂	yutang
沙井大道	shajingdadao
越溪	yuexi
广安	guangan
兰亭巷	lantingxiang
方中圆商业街	fangzhongyuanshangyejie
苜蓿园	muxuyuan
潞苑	luyuan
三高路	sangaolu
老北站	laobeizhan
和平街	hepingjie
银通	yintong
小金口	xiaojinkou
大良	daliang
庙城	miaocheng
奥体中心	aotizhongxin
富宁街	xingqingfuningjie
新立	xinli
江热夏	jiangrexia
扬子江路	yangzijianglu
镇湖	zhenhu
开发西区	kaifaxiqu
大经路	dajinglu
盘城	pancheng
北大地	beidadi
文三路	wensanlu
白洋湾	baiyangwan
望城坡	wangchengpo
上海	shanghai
滨江路	binjianglu
无瑕	wuxia
笔架山	bijiashan
宁夏路	ningxialu
索凌路	suolinglu
大连路	dalianlu
工体	gongti
王庄路	wangzhuanglu
北湖路	beihulu
冉家坝	ranjiaba
小王庄	xiaowangzhuang
木材	mucai
卫岗	weigang
南滨路	nanbinlu
东城区	dongchengqu
万松	wansong
青山南路	qingshannanlu
马连洼	malianwa
宋家庄	songjiazhuang
法华寺	fahuasi
良口	liangkou
石井	shijing
大梅沙	dameisha
义城	yicheng
北园大街历城段	beiyuandajielichengduan
海湾	haiwan
横泾	hengjing
红庙坡	hongmiaopo
则徐大道	zexudadao
友好南路	youhaonanlu
陶家	taojia
蔺市	linshi
三塘	santang
桃园路	taoyuanlu
西三教	xisanjiao
西镇	xizhen
长临河	changlinhe
望海楼	wanghailou
生米	shengmi
宋营	songying
陈嘴	chenzui
城角	chengjiao
丰产路	fengchanlu
南园新村	nanyuanxincun
建筑新村	jianzhuxincun
梨园城铁	liyuanchengtie
垡头	fatou
红旗药号	hongqiyaohao
亲海园	qinhaiyuan
东山口	dongshankou
团岛	tuandao
高新园区管委会	gaoxinyuanquguanweihui
文化街	wenhuajie
二环南路	erhuannanlu
城郊	chengjiao
南江滨路	nanjiangbinlu
五凤	wufeng
文昌	wenchang
幸福街	xingfujie
西便门	xibianmen
蒋村	jiangcun
铃铛阁	lingchengge
雄州	xiongzhou
文锦渡	wenjindu
黄河路以北	huangheluyibei
五峰山	wufengshan
军乐	junle
红庙	hongmiao
公主坟	gongzhufen
吉日	jiri
金虹桥	jinhongqiao
黄旗山	huangqishan
蔡屋围	caiwuwei
万顺	wanshun
上安	shangan
双岗	shuanggang
霍德	huode
兴城路	xingchenglu
窖口	jiaokou
甜水井	lianhutianshuijing
美里湖	meilihu
临沂北站	linyibeizhan
孔浦	kongpu
百步亭	baibuting
松湖	songhu
香港路	aomenluyinan
广州大道北	guangzhoudadaobei
牛家牌	niujiapai
胜利路	shenglilu
永盛门	yongshengmen
劳动西路	laodongxilu
皇冠	huangguan
广埠屯	guangbutun
梅花园	meihuayuan
燕子矶	yanziji
府前巷	fuqianxiang
前海	qianhai
英华街	yinghuajie
通桥	tongqiao
新和路	xinhelu
阳坊	yangfang
祝塘镇	zhutangzhen
高叶塘	gaoyetang
艳粉	yanfen
书圣街	shushengjie
雪乡	xuexiang
华乐	huale
郭杜	guodu
临岐	linqi
北环	beihuan
韩森寨	hansenzhai
王村南街	wangcunnanjie
草滩	caotan
兴学街	xingxuejie
真如	zhenru
祥和	xianghe
石油新村	shiyouxincun
衡阳	hengyang
积玉桥	jiyuqiao
青光	qingguang
开拓路	kaituolu
葵涌	kuichong
坪地	pingdi
海王大厦	haiwangdasha
南礼士路	nanlishilu
科学园	kexueyuan
华仙路	huaxianlu
桔子洲	juzizhou
九江镇	jiujiangzhen
重庆南路	zhongqingnanlu
桂花公园	guihuagongyuan
东渚	dongzhu
金地商都	jindishangdu
湖光路	huguanglu
洪山桥	hongshanqiao
江多	jiangduo
仁义	renyi
圣灯	shengdeng
洪蓝	honglan
一品	yipin
化龙桥	hualongqiao
信息城	xinxicheng
中亭街	zhongtingjie
江宁路	jiangninglu
碧云	biyun
建设南路	jianshenanlu
均安	junan
满都户	manduhu
芝罘区	zhifuqu
北园	beiyuan
黎华小区	lihuaxiaoqu
北苑	tongzhoubeiyuan
昆仑商城	kunlunshangcheng
金海湖	jinhaihu
杨树房	yangshufang
西园新村	xiyuanxincun
张家村	zhangjiacun
桥南片区	qiaonanpianqu
毓璜顶	yuhuangding
龙河	longhe
杨柳	yangliu
角门	jiaomen
张官营	zhangguanying
镇罗营	zhenluoying
巢湖路	chaohulu
电子城	dianzicheng
淞宝	songbao
爵溪	juexi
都拉营	dulaying
沙坪	shaping
省政府	shengzhengfu
奇山	qishan
南油	nanyou
渝州路	yuzhoulu
井湾子	jingwanzi
白塔路	baitalu
东山区	dongshanqu
金霞路	jinxialu
深圳湾	shenzhenwan
二府庄	erfuzhuang
城隍庙	chenghuangmiao
天津街	tianjinjie
春堆	chundui
龙泉路	longquanlu
迎宾大道	daishan
三槐路	sanhuailu
大场	dachang
卫星广场	weixingguangchang
李河	lihe
腊山北路	lashanbeilu
雅塘村	yatangcun
华港新村	huagangxincun
中长	zhongchang
魁奇	kuiqi
湖岛	hudao
石井坡	shijingpo
安宁庄	anningzhuang
东部市场	dongbushichang
二沙岛	ershadao
秋林	qiulin
动植物园	dongzhiwuyuan
温江城区	liucheng
源深竹园	yuanshenzhuyuan
大院	dayuan
三元桥	sanyuanqiao
市九龙	shijiulong
沙口路	ruidalushakoulu
陇海马路	longhaimalu
张槎	zhangcha
石板	shiban
永盛	yongsheng
潮鸣	chaoming
朝阳公园	chaoyanggongyuan
丹凤街	danfengjie
八道湾	badaowan
炭步	tanbu
湖前	huqian
山大路	shandalu
西二环南路	xierhuannanlu
广州大道南	guangzhoudadaonan
南村	nancun
西部工业区	xibugongyequ
合江亭	hejiangting
中梁	zhongliang
市政府片区	shizhengfupianqu
得胜	lvshunkoudesheng
广电中心	guangdianzhongxin
湖塘乐购	hutanglegou
横扇	hengshan
太阳岛	taiyangdao
曹庵	caoan
甜水园	tianshuiyuan
峪口	yukou
福永	fuyong
大沽街	dagu
观音岩	guanyinyan
回龙坝	huilongba
新华街	xinhuajie
富乐大桥	fuledaqiao
大成	dacheng
远洋路	yuanyanglu
石坝	shiba
上夼	shangkuang
海棠	haitang
二七南路	erqinanlu
春晖路	dadukouchunhuilu
冲赛康	chongsaikang
卡子湾	kaziwan
普陀路	putuolu
卸甲甸	xiejiadian
云台	yuntai
通江大道	tongjiangdadao
团泊	tuanbo
桑珠林	sangzhulin
南岸路	nananlu
新城子	xinchengzi
敦化路	dunhualu
文化广场	wenhuaguangchang
马连道	xuanwumaliandao
湘雅三医院	xiangyasanyiyuan
后洲	houzhou
柳荫	liuyin
唐家口	tangjiakou
皇姑屯火车站	huanggutun
大疃	datuan
红钢城	honggangcheng
白合	baihe
龙丰、上排、红花湖	longfengshangpaihonghuahu
公交新村	gongjiaoxincun
站街	zhanjie
天桥东街	tianqiaodongjie
高村	gaocun
棠景	tangjing
王庄	wangzhuang
姚家	yaojia
贺丞路	hechenglu
卫工	weigong
桃苑	taoyuan
大榆树	dayushu
三鹏广场	sanpengguangchang
光明	guangming
火车北站	lianmeng
万寿	wanshou
怒江北街	nujiang
黄埔区府	huangpuqufu
嘉陵道	jialingdao
银桥街	yinqiaojie
赤尾	chiwei
亭林	tinglin
马园	mayuan
上陡门	shangdoumen
经十路中段	jingshiluzhongduan
河滨	hebin
申花	shenhua
三墙路	sanqianglu
西南财大	xinancaida
四公里	sigongli
大胡同	dahutong
湘潭路楼山	xiangtanluloushan
八廓	bakuo
田村	tiancun
清洋	qingyang
上海滩社区	shanghaitanshequ
五一北路	wuyibeilu
军庄	yuzhuang
桐梓林	tongzilin
沂蒙二路	yimengerlu
纺织城	fangzhicheng
虎山	hushan
千佛山	qianfoshan
嵩阳	songyang
老闵行	laominhang
帮洲街	bangzhoujie
走马	wanzhouzouma
金陵小区	jinlingxiaoqu
向阳街	xiangyang
金星大道	jinxingdadao
永定门	yongdingmen
人民公园	wangjiaguai
景山	jingshan
柘林	zhelin
丰州路	fengzhoulu
五一路	wuyilu
内厝	neicuo
桐君	tongjun
友好北路	youhaobeilu
矿泉	kuangquan
通达街	tongda
文冲	wenchong
平洲	pingzhou
世回尧	shihuiyao
羊达	yangda
那陈	nachen
薛家岛	xuejiadao
白佛	baifo
莱山区	laishanqu
百安坝	baianba
古林街	gulin
山东头	shandongtou
钟林路	zhonglinlu
虎门公园	humengongyuan
槐安路	huaianluqx
杨宋	yangsong
徐泾	xujing
歇马	xiema
万科城	wankecheng
新鸿路	xinhonglu
大季家	dajijia
林亭口	lintingkou
民族	minzu
巴福	bafu
锦水路	jinshuilu
白马	baima
利津路	lijinlu
怡乐路	yilelu
草桥	caoqiao
白鹤	baihe
彩香	caixiang
模式口	moshikou
牛街	niujie
山北	shanbei
广中路	guangzhonglu
致韩	zhihan
松江老城	songjianglaocheng
狮岭	shiling
学院街	xueyuanjie
胶州路	jiaozhoulu
齐礼阎	qiliyan
人民中路	renminzhonglu
长泾镇	zhangjingzhen
半山	banshan
凤川	fengchuan
石厦	shisha
爱建	aijian
柳梧	liuwu
孛兰	beilan
汉渝路	hanyulu
舜耕路	shungenglu
高柱	gaozhu
银盆岭	yinpenling
皇寺	beizhan
张公	zhanggong
世纪城	shijicheng
金马	jinma
顶山	dingshan
高塍镇	gaochengzhen
旺庄街道	xinquwangzhuangjiedao
镇江路	zhenjianglu
大王古庄	dawangguzhuang
港湾街	gangwanjie
洲头	zhoutou
庆丰街	qingfengjie
明德门	mingdemen
邓南	dengnan
生产路	shengchanlu
罗溪	luoxi
天心周边	tianxinzhoubian
三岔	sancha
龙潭湖	longtanhu
荷花园	hehuayuan
香店	xiangdian
石铜路	shitonglu
丹灶	danzao
金三角	jinjiajie
徐东	xudong
周门	zhoumen
友谊路	youyilu
溧水开发区	lishuikaifaqu
oY	yundang
又新	youxin
王辛庄	wangxinzhuang
724地区	wenguan
南湖汽车站	nanhuqichezhan
北干	beigan
黄泥磅	huangnibang
三里庵	sanlian
建兰路	jianlanlu
十里河	shilihe
江汉路	jianghanlu
自行车厂	zixingchechang
市西路	shixilu
淮海西路	huaihaixilu
水风井	shuifengjing
玉峰山	yufengshan
丰禾路	fenghelu
钟落潭	zhongluotan
王家桥	wangjiaqiao
邻鄂	line
甸柳新村	dianliuxincun
二仙桥	erxianqiao
朔方路	shuofanglu
蠡湖街道	lihujiedao
犁弯	liwan
汶水路	wenshuilu
登州路	dengzhoulu
土桥	tuqiao
丰乐	fengle
小海地	xiaohaidi
寿泉	shouquan
左家塘	zuojiatang
下渡	xiadu
清河路	qinghelu
凯旋门	kaixuanmen
菜园坝	yuzhongcaiyuanba
荷花池	hehuachi
九宫庙	jiugongmiao
辉山	huishan
东二营	dongerying
潘塘	pantang
曾家	cengjia
兴建	xingjian
瑞金路	ruijinlu
象湖新城	xianghuxincheng
南川东路	nanchuandonglu
大白庄	dabaizhuang
孙各庄满族	sungezhuangmanzu
北庄	beizhuang
铭熙水岸	mingxishuian
香海连天	xianghailiantian
和平公园	hepinggongyuan
惜福	xifu
母亲广场	muqinguangchang
徐家棚	xujiapeng
明湖路	minghulu
西大直街	songhuajiang
南木	nanmu
松洲	songzhou
三医院	sanyiyuan
升平	shengping
河桥	heqiao
周谷堆	zhougudui
牛玛	niuma
上庄	shangzhuang
杨庄	yangzhuang
子牙	ziya
五羊新城	wuyangxincheng
双月路	shuangyuelu
服装城	fuzhuangcheng
阜新路	fuxinlu
大集	daji
阳明东路	yangmingdonglu
扎佐	zhazuo
青城山	qingchengshan
通乡商店	tongxiang
能仁里	nengrenli
团结路	tuanjielu
可园	keyuan
陈家镇	chenjiazhen
东北	dongbei
银川路	yinchuanlu
中百	zhongbai
新华南路	xinhuananlu
大河路	dahelu
抚河	fuhe
李店	lidian
长	changban
新开铺	xinkaipu
繁荣路	fanronglu
义洲	yizhou
滨江道	binjiangdao
科技路西口	kejiluxikou
张村	zhangcun
经七纬十二	jingqiweishier
芙蓉北路	furongbeilu
辽师	liaoshi
青年公园	qingniangongyuan
六广	liuchang
科教新村	kejiaoxincun
福民新村	fuminxincun
南窑片区	nanyaopianqu
金杨新村	jinyangxincun
崖头	yatou
建港路	jianganglu
张庙	zhangmiao
培元桥	peiyuanqiao
含谷	hangu
金贵	jingui
咸水沽	xianshuigu
大北涧沽	dabeijiangu
国家经济开发区	guojiajingjikaifaqu
傅家坡	fujiapo
红旗河沟	hongqihegou
新伟	xinwei
动植物公园	dongzhiwugongyuan
津南周边	jinnanzhoubian
黄台路	huangtailu
朱泾	zhujing
伏龙坪	fulongping
洋溪	yangxi
沣惠南路	fenghuinanlu
界石	jieshi
民德路	mindelu
苏州	suzhou
九龙湖	jiulonghu
育才路	yucailu
双井	shuangjing
渤海镇	bohaizhen
天生	beibeiwansheng
西龙虎峪	xilonghuyu
贵阳街	guiyangjie
船山路	nanpu
观海路	guanhailu
黄沙	huangsha
北	beijiao
天一广场	tianyiguangchang
省博物馆	shengbowuguan
广润门	guangrunmen
大通路	datonglu
双桥子	shuangqiaozi
集贤里	jixianli
华山路	huashanlu
程林	chenglinjie
广瑞路街道	guangruilujiedao
凌空	lingkong
白云街	baiyunjie
延安路	yananlu
人民街	renminjie
茶南	chanan
南辛庄	nanxinzhuang
凤凰西街	fenghuangxijie
周家桥	zhoujiaqiao
果园新村	guoyuanxincun
琥珀山庄	hupo
汾口	fenkou
李村公园	licungongyuan
湖东	hudong
矿区医院	kuangquyiyuan
公兴	gongxing
红旗小区	hongqixiaoqu
东南湖大路	dongnanhudalu
杆石桥	ganshiqiao
西把栅乡政府	xibazhaxiangzhengfu
双闸	shuangzha
二环东路北段	erhuandonglubeiduan
老福山	laofushan
西门路	ximenlu
西山区政府	xishanquzhengfu
十字街	shizijie
体育西路	tiyuxilu
下渡路	xiadulu
一号桥	yihaoqiao
青林湾	qinglinwan
北京路	beijinglu
丁白路	dingbailu
大商汇	dashanghui
沧浪新城	canglangxincheng
千山路	qianshanlu
望岳	wangyue
五里庙	wulimiao
西泡	xipao
梅村镇	xinqumeicunzhen
赵家	zhaojia
鼓东	gudong
纱帽	shamao
河北周边	hebeizhoubian
联洋	lianyang
芙蓉南路	furongnanlu
德雅路	deyalu
莱蒙都会	laimengduhui
黄村	huangcun
大王庄	dawangzhuang
华威桥	huaweiqiao
红凌路	honglinglu
杨士	yangshi
闲林	xianlin
解放东路	jiefangdonglu
三峡广场	sanxiaguangchang
燕山立交	yanshanlijiao
石各庄	wuqingshigezhuang
东关南街	dongguannanjie
五里堡	wulipu
太龙	tailong
广州大道中	guangzhoudadaozhong
敦仁	dunren
葵英街	caiying
好又多	haoyouduo
五象大道	wuxiangdadao
小关	xiaoguan
华师大	huashida
舜华路	shunhualu
民意	minyi
裕东	yudong
永定路	yongdinglu
安定门	andingmen
三圣	sansheng
芦台	lutai
程林庄	chenglinzhuang
虹山片区	hongshanpianqu
长沙卷烟厂	zhangshajuanyanchang
北沙滩	beishatan
壮锦大道	zhuangjindadao
莲塘	liantang
申中	shenzhong
幕府山	mufushan
新民广场	xinminguangchang
泗村店	sicundian
李子坝	liziba
香坊大街	xiangfangdajie
前十大街	qianshidajie
等驾坡	dengjiapo
胜北	shengbei
山南	shannan
红牌楼	hongpailou
福华新村	fuhuaxincun
清河农场	qinghenongchang
新市府	xinshifu
华正	huazheng
水部	shuibu
前横路	qianhenglu
象山南路	xiangshannanlu
广渠门	guangqumen
民主东街	minzhudongjie
弹子	danzi
南京路	jinhulu
宁国路	ningguolu
华侨城	huaqiaocheng
双水碾	shuangshuinian
首义路	shouyilu
桂芳园	guifangyuan
临邛	linqiong
福海路	fuhailu
永安里	yonganli
双龙湖	shuanglonghu
汤河	shanghe
济齐路	jiqilu
解放南路	jiefangnanlu
天目西路	tianmuxilu
杨士岗	yangshigang
营城	yingcheng
皇岗	huanggang
长江路	zhangjianglu
花地湾	huadiwan
北站	xinbeizhan
四惠	sihui
槐北	huaibei
长缨东路	zhangyingdonglu
农兴	nongxing
辛口	xinkou
富民路	fuminlu
港湾广场	gangwanguangchang
市府路	shifulu
金星	jinxing
北宅	beizhai
永盛路	yongshenglu
十三陵	shisanling
旅顺南路	lvshunnanlu
北京西路	beijingxilu
创业大道	chuangyedadao
国际海水浴场	guojihaishuiyuchang
荷花路	hehualu
满春	manchun
杭州道	hangzhoudao
土贤庄	tuxianzhuang
华明	huaming
扎基	zhaji
三合路	sanhelu
龙头寺	longtousi
徐官屯	xuguantun
天山大街	tianshandajie
西塔	xita
新东	xindong
矿山	kuangshan
帕古	pagu
新港	xingang
科技二路	kejierlu
嘉定路	jiadinglu
槐西	huaixi
八一七北路	bayiqibeilu
杜岭	duling
华东理工	huadongligong
伍家岭	wujialing
古北口	gubeikou
后山	houshan
锁金村	suojincun
白水坝	baishuiba
四中路	sizhonglu
道明	daoming
灵桥	lingqiao
大智街	dazhi
一马路	yimalu
董家渡	dongjiadu
北杜	beidu
安达街	andajie
海滨	haibin
锡林路	xilinlu
温泉路	wenquanlu
古城台	guchengtai
鹿乡	luxiang
三堡	sanpu
武东	wudong
山洞	shandong
学院路	xueyuanlu
龙塘	longtang
富强	fuqiang
东天街	dongtianjie
市政府小区	shizhengfuxiaoqu
北三路	beisanlu
小平岛	xiaopingdao
白坭	baini
北新街	beixinjie
荷叶塘	heyetang
大屯	datun
江浦	jiangpu
汉兴	hanxing
万福街	wanfujie
光华	guanghua
滨江东	binjiangdong
胡家园	hujiayuan
净水路	jingshuilu
龙滩子	longtanzi
市场	shichang
建设二路	jiansheerlu
花东	huadong
神山	shenshan
望州岭	wangzhouling
永阳	yongyang
石洞	shidong
中北	zhongbei
大湾	dawan
东江新城	dongjiangxincheng
通泰路	tongtailu
大外	dawai
向阳路	xiangyanglu
沿庄	yanzhuang
二十里堡	ershilipu
麦岛	maidao
黄桷桠	huangjueya
井冈山大道	xujiafang
延陵西路	yanlingxilu
统景	tongjing
庐山南大道	lushannandadao
中堡	zhongbao
水心	shuixin
新中路立交桥	xinzhonglulijiaoqiao
儿童公园	ertonggongyuan
外滩	waitan
新疆街	xinjiangjie
龙门山	longmenshan
西龙王庙	xilongwangmiao
陈家祠	chenjiaci
解放四村	jiefangsicun
港务局	zhenjiang
仰天湖	yangtianhu
塘南	tangnan
辛家庄	xinjiazhuang
休门	xiumen
凤岭北	fenglingbei
北塘街	beitang
雨花区政府	yuhuaquzhengfu
莫愁	mochou
东坝	dongba
华南广场	huananguangchang
段塘	duantang
二里岗	erligang
丹景山	danjingshan
西藏北路	xizangbeilu
大魏家	daweijia
增光路	zengguanglu
经十东路	jingshidonglu
阳明路	yangminglu
敦化坊	dunhuafang
南站	nanzhan
回龙湾	huilongwan
只楚	zhichu
临夏路	linxialu
未来路	weilailu
临平路	linpinglu
早春园	zaochunyuan
丰庄	fengzhuang
金星立交桥	jinxinglijiaoqiao
双口	shuangkou
水屯路	shuitunlu
南寨	nansai
南沱	nantuo
西江滨	xijiangbin
明家	mingjia
桃园街	taoyuan
大面	damian
呼家楼	hujialou
人民东路	renmingdonglu
蓬东	pengdong
祥瑞路	ruixianglu
凤天路	fengtianlu
高境	gaojing
汉水路	hanshuilu
南广场	nanguang
煌逭	yingwanzhen
花乡	huaxiang
东屯渡	dongtundu
油榨街	youzhajie
侏儒	zhuru
黄松峪	huangsonggu
湛山	zhanshan
晋陵北路	jinlingbeilu
初村	chucun
中信石竹	zhongxinshizhuxin
鞍山	anshan
蛇口	shekou
浒山	hushan
东岗东路	donggangdonglu
长芦	changlu
二郎	erlang
52街区	52jiequ
菜纳	caina
鲁山道	lushandao
靖远路	jingyuanlu
贾庄	jiazhuang
兴凯路	xingkailu
三大动力	jiankanglu
河马石	hemashi
塘果	tangguo
西柯	xike
平望	pingwang
张家湾	zhangjiawan
黎明	liming
千峰	qianfeng
孔家崖	kongjiaya
松江新城	songjiangxincheng
八斗	badou
育黎	yuli
东明中学	dongmingzhongxue
布心	buxin
茄子溪	qiezixi
九路市场	jiulushichang
马巷	maxiang
小东门	xiaodongmen
同集路	tongjilu
衡阳路	hengyanglu
云谷工业区	yungugongyequ
夹关	jiaguan
周家泉	zhoujiaquan
边家村	bianjiacun
季华路	jihualu
两河	lianghe
兰陵巷	lanlingxiang
逢源	fengyuan
广济桥	guangjiqiao
馆驿街	guanyijie
湖滨南路	hubinnanlu
元和	yuanhe
东亭	dongting
东四十条	dongsishitiao
营门口	yingmenkou
双碑	shuangbei
久长	jiuchang
九州大厦	jiuzhoudasha
泥岗	nigang
凤仪	fengyi
杉岭	shanling
亚明	yaming
石井区	shijingqu
福建路	fujianlu
张掖路	zhangyelu
西稍门	xishaomen
出江	chujiang
英才街	yingcaijie
共和新路	gonghexinlu
聚源	juyuan
南城车站	nanchengchezhan
正阳路	zhengyanglu
嘉定镇	jiadingzhen
渔阳	yuyang
新发	xinfa
便益门广场	bianyimenguangchang
漕宝路地铁	caobaoluditie
控江路	kongjianglu
白蕉镇	baijiaozhen
晴川	qingchuan
三门坡	sanmenpo
长塘镇	zhangtangzhen
东方广场	dongfangguangchang
积米崖	jimiya
平新	pingxin
吉祥	jixiang
济源路	jiyuanlu
新繁	xinfan
盛泽	shengze
沙岭	shaling
青岛路	qingdaolu
沂蒙路	yimenglu
华家屯	huajiatun
彩宇大街	caiyudajie
清泉寨	qingquanzhai
草埔	caobu
老余杭	laoyuhang
科技城	kejicheng
侨英	qiaoying
上马墩街道	shangmadunjiedao
驰誉	chiyu
金鸡岭	jinjiling
田心村	tianxincun
旧区	jiuqu
错埠岭	cuobuling
石美	shimei
开发区周边	kaifaquzhoubian
明楼	minglou
珠江桥	kejian
牡丹园	mudanyuan
草铺	caopu
光华大道	yongquan
乐从	lecong
理工大学	ligongdaxue
新港西	xingangxi
丹水池	danshuichi
水田	shuitian
双月园路	shuangyueyuanlu
长乐宫	changlegong1
高行	gaohang
阿朗	alang
乳山寨	rushanzhai
芳草街	fangcaojie
翠微	cuiwei
江埔	jiangpu
明廉	minglian
韦曲	weiqu
省农机校	shengnongjixiao
鹿山	lushan
星光大道	xingguangdadao
南邵	nanshao
六里	liuli
锦绣	jinxiu
八里台	nankaibalitai
马昌营	machangying
青年路	qingnianlu
白市驿	baishiyi
海云庵	haiyunan
千岛湖	qiandaohu
文庙	wenmiao
斜源	xieyuan
温圳	wenzhen
敖平	aoping
石湾	shiwan
华苑	huayuan
蓟门桥	jimenqiao
乐化	lehua
翠华路	cuihualu
虹桥	changninghongqiao
劲松	jingsong
东平路	dongpinglu
多林	duolin
长海县	changhaixian
莲花一村	lianhuayicun
南关客运站	nanguankeyunzhan
街子	jiezi
上田路	shangtianlu
凯旋路	kaixuan
招贤	zhaoxian
杏东路	xingdonglu
密渡桥路	miduqiaolu
六铺炕	liupukang
慈惠墩	cihuidun
东岭南街	donglingnanjie
陆家	lujia
顾村	gucun
长庆	changqing
大学路	daxuelu
大唐庄	datangzhuang
琅岐	langqi
康庄	kangzhuang
龙门浩	longmenhao
道德街	daodejie
东赵各庄	dongzhaogezhuang
盛能游乐	shengnengyouyue
北宫	beigong
北闸口	beizhakou
浏城桥	liuchengqiao
金匮街道	jinkuijiedao
辛安渡	xinandu
火炬大厦	huojudasha
幸福	xingfu
宁华路	ninghualu
大弯	dawan
海湾旅游区	haiwanlvyouqu
双月门	shuangyuemen
北房	beifang
花桥	huaqiao
石堰	shiyan
崇平	chongping
万寿寺	wanshousi
凤城一路	fengchengyilu
兴工	xinggong
新香洲	xinxiangzhou
东涌	dongyong
十里店	shilidian
定王台	dingwangtai
二经	erjing
周良庄	zhouliangzhuang
成龙路	chenglonglu
朝阳门	chaoyangmen
六一中路	liuyizhonglu
丽泽桥	lizeqiao
华林路	hualinlu
迎宾路	yingbinlu
亲仁	qinren
三十里堡	sanshilipu
建宁路	jianninglu
花侨	huaqiao
樵舍	qiaoshe
老香洲	laoxiangzhou
南桥	nanqiao
南河大桥	nanhedaqiao
花家地	huajiadi
柳青路	liuqinglu
涑河南路	suhenanlu
洗面桥	ximianqiao
鲁班路	lubanlu
第三大街	disandajie
覃家岗	tanjiagang
大张庄	dazhangzhuang
驷马桥	simaqiao
东关大街	dongguandajie
桃浦	taopu
普兴	puxing
金山小区	jinshanxiaoqu
汽车东站	qichedongzhan
川沙	chuansha
百汇街	baihuijie
杨箕村	yangqicun
成山	chengshan
天水	tianshui
唐口	tangkou
炉院街	luyuanjie
富春	fuchun
体育新城	tiyuxincheng
猛追湾	mengzhuiwan
药山	yaoshan
势	xiepu
二牛所口	erniusuokou
东泰	dongtai
建明	jianming
西樵	xiqiao
体育中心	tiyuzhongxin
纬北路	weibeilu
桂庙路口	guimiaolukou
龙驹	longju
大城山公园	dachengshangongyuan
长江大道	changjiangdadao
淀山湖	dianshanhu
碧湘街	bixiangjie
友好广场	youhaoguangchang
迎宾街	yingbin
世纪大酒店	shijidajiudian
幸福路	xingfulu
向阳楼	xiangyanglou
东塘	dongtang
小寨坝	xiaozhaiba
天塔	tianta
腾家	tengjia
杨村	yangcun
上地	shangdi
梅陇	meilong
珞南	luonan
鱼儿沟	yuergou
新塘	zengchengxintang
南院门	nanyuanmen
叶茂台	yemaotai
文昌街	wenchangjie
硕放	shuofang
长城路	changchenglu
柏林	bolin
中旺	zhongwang
红军大街	hongjundajie
李家墩	lijiadun
蓝天	lantian
站北	zhanbei
桃源村	taoyuancun
下元	xiayuan
金花	jinhua
鸳鸯	yuanyang
逍遥津	xiaoyaojin
丁桥	dingqiao
小孤山	xiaogushan
大行宫	daxinggong
汾湖	fenhu
杨镇	yangzhen
交通大学	jiaotongdaxue
曙光路口	shuguanglukou
广园东	guangyuandongzc
洪湾路	hongwanlu
上元大街	shangyuandajie
杜北	dubei
樱园	yingyuan
青年	qingnian
葛塘	getang
铁山坪	tieshanping
朝安	chaoan
大庆南路	daqingnanlu
苏坡	supo
万泉	wanquan
朱村	zhucun
梓桐	zitong
小营	xiaoying
石岩	shiyan
南闸镇	nanzhazhen
下梅林	xiameilin
红旗路	hongqilu
红花	honghua
大信	daxin
王舍人	wangsheren
孟家	mengjia
三湘大市场	sanxiangdashichang
高新开发区	gaoxinkaifaqu
金水路	jinshuilu
顺通	shuntong
文化南路	wenhuananlu
北外滩	beiwaitan
两汇	lianghui
学府大道	xuefudadao
青剑湖	qingjianhu
大桥道	daqiaodao
挂甲寺	guajiasi
长寿湖	changshouhu
葛化	gehua
龚家湾	gongjiawan
石羊	wuhoushiyang
张家窝	zhangjiawo
科学城	kexuecheng
荷兰村	helancun
湖南崖	hunanya
辉南街	huinanjie
中山路	zhongshanlu
老军营	laojunying
东风村	dongfengcun
天光路	tianguanglu
赛维拉	saiweila
新华路	xinhualu
三里街	sanlijie
银川西路	yinchuanxilu
玫瑰大楼	meiguidalou
哈达	hada
夏村	xiacun
石羊桥东路	shiyangqiaodonglu
沥	lijiao
蛟桥	jiaoqiao
黄甲	huangjia
新阳工业区	xinyanggongyequ
绿地老街	lvdilaojie
惠工	huigong
丛林	wanshengconglin
客运东站	keyundongzhan
甘家口	haidianganjiakou
昆明路	kunminglu
朝天门	chaotianmen
横塘	hengtang
仙霞新村	xianxiaxincun
郭茨口	guocikou
黑水路	heishuilu
世博片区	shibopianqu
龙洞	longdong
全福庄	quanfuzhuang
延陵东路	yanlingdonglu
将军路	jiangjunlu
新街口	xinjiekou
机场	jichang
长和廊	zhanghelang
海椒市	haijiaoshi
先锋路	xianfenglu
中山三路	zhongshansanlu
葛兰	gelan
万体馆	wantiguan
新民屯	xinmintun
老山	laoshan
色麦	semai
沧虹路	canghonglu
白云新村	baiyunxincun
新村	xincun
大桥南路	daqiaonanlu
沙河镇	shahezhen
罗星	luoxing
周庄	zhouzhuang
王浩儿	wanghaoer
五四路	wusilu
长河	changhe
乌龙泉	wulongquan
乐松	anle
张前路	zhangqianlu
丰益桥	fengyiqiao
北陵	beiling
贝森	beisen
希望广场	xiwangguangchang
倚山里	yishanli
王府井	wangfujing
北新泾	beixinjing
盐场	yanchang
北林路	beilinlu
北营	beiying
蒲黄榆	puhuangyu
肇嘉浜路	zhaojiabanglu
偏岩	pianyan
波航	bohang
铁西体育场	qinggong
冈上	gangshang
西门	ximen
工业路	gongyelu
人民商场	renminshangchang
鞍山路	anshanlu
上五庄	shangwuzhuang
东站片	dongzhanpian
党家镇	dangjiazhen
市桥	shiqiao
白沙街	baishajie
西山水库	xishanshuiku
正兴	zhengxing
木渎	mudu
望京	wangjing
国贸	guomao
海口	haikou
北村	beicun
新春	xinchun
红光农场	hongguangnongchang
人民	renmin
方新村	fangxincun
溪口	xikou
木洞	mudong
铁道学院	tiedaoxueyuan
雁山立交桥	yanshanlijiaoqiao
文兰	wenlan
东海街	donghai
石滩	shitan
南泉	nanquan
南山路	nanshanlu
近江	jinjiang
普澜	pulan
彭浦	pengpu
余家	yujia
彩虹路	caihonglu
方庄	fangzhuang
百汇购物中心	baihuigouwuzhongxin
方家屯	fangjiatun
韶山南路	shaoshannanlu
么六桥	meliuqiao
云南路	yunnanlu
林家崖	linjiaya
塔山	tashan
后沙峪	houshayu
窑岭	yaoling
孺子路	ruzilu
员村	yuancun
公德林	gongdelin
南黄	nanhuang
南桥寺	nanqiaosi
更合	genghe
大众街	dazhongjie
东门外	dongmenwai
崖子	yazi
城东路	chengdonglu
德民路	deminlu
王口	wangkou
太榆路	taiyulu
中关村	zhongguancun
南苑	nanyuan
团结湖	tuanjiehu
南源	nanyuan
南屏	nanping
二马路	ermalu
胜浦	shengpu
汽博中心	qibozhongxin
矿大	kuangda
杭州路	hangzhoulu
火井	huojing
政务中心	zhengwuzhongxin
西村	xicun
六家畈	liujiafan
登仕堡子	dengshipuzi
湖西街	huxijie
开源路	kaiyuanlu
国奥现代城	guoaoxiandaicheng
玉泉营	yuquanying
新发地	xinfadi
新\	xinqi
南浦	nanpu
临沂大学	linyidaxue
西安桥	xianqiao
安吉大道	anjidadao
工农村	gongnongcunjie
大塘	datang
廖家	liaojia
后宰门	houzaimen
金雀山路	jinqueshanlu
华苑南	huayuannan
平凉路	pinglianglu
保儿	baoer
迎新街	yingxinjie
湖墅	hushu
南坪	nanannanping
灵山卫	lingshanwei
大庆北路	daqingbeilu
滨港路	binganglu
潭柘寺	taizhesi
江桥	jiangqiao
盖州街	gaizhoujie
梅墟	meixu
硅谷广场	guiguguangchang
印斗路	yindoulu
延安三路	yanansanlu
湘江世纪城	xiangjiangshijicheng
陈坪	chenping
火车站周边	huochezhanzhoubian
文二路	wenerlu
角美	jiaomei
榄核	lanhe
国防科大	guofangkeda
枫泾	fengjing
中塘	zhongtang
银江路	yinjianglu
天河北	tianhebei
邢台路	xingtailu
新城街道	xinchengjiedao
埠柳	buliu
西直门	xichengxizhimen
金盆岭	jinpenling
长寿路	zhangshoulu
西关大街	xiguandajie
肉联厂	roulianchang
马栏	malan
长沙理工大学	zhangshaligongdaxue
柳芳	liufang
百家湖	baijiahu
维明	weiming
哈量	haliang
高升桥	gaoshengqiao
齐鲁软件园	qiluruanjianyuan
富锋	fufeng
东门	dongmen
文华园	wenhuayuan
黄河东路	huanghedonglu
双港	shuanggang
太阳沟	taiyanggou
建工学院	jiangongxueyuan
上渡	shangdu
204医院	204yiyuan
乳山口	rushankou
海悦山小区	haiyueshanxiaoqu
东盛启城	dongshengqicheng
绍兴路	shaoxinglu
长征街	changzhengjie
江大南路	jiangdananlu
府前街	fuqianjie
聚贤街	juxianjie
漪汾	yifen
南郊公园	nanjiaogongyuan
西北湖	xibeihu
星桥	xingqiao
祈福	qifu
仙村	zengchengxiancun
二环西路	erhuanxilu
西街	xijie
李园	liyuan
忠诚街	zhongchengjie
净月大学城	jingyuedaxuecheng
庄市	zhenhaizhuangshi
复兴公园	fuxinggongyuan
大营	daying
官南大道	guannandadao
涧河	jianhe
合作路	hezuolu
五凌电力	wulingdianli
老鸦陈	laoyachen
中北路	zhongbeilu
高科花园	gaokehuayuan
五桥	wuqiao
天元东路	tianyuandonglu
西焦	xijiao
五一商店	wuyishangdian
素社	sushe
景湖花园	jinghuhuayuan
渤海石油	haiyangshiyou
冶金	yejin
蔡场	caichang
鸡冠石	jiguanshi
平江新城	pingjiangxincheng
西姜	xijiang
清明街	qingming
新柳	xinliu
太湖花园	taihuhuayuan
谌家矶	chenjiaji
成仁路	chengrenlu
东陈岗	dongchengang
太华路	taihualu
青浦北部	qingpubeibu
国展中心	guozhanzhongxin
长乐中路	zhanglezhonglu
茶会	chahui
徐寨	xuzhai
平溪	pingxi
斜口	xiekou
千灯	qiandeng
玉桥	yuqiao
青阳镇	qingyangzhen
于埠	yubu
元岗	yuangang
松峪里	songyuli
人民广场东	renminguangchangdong
白石路文化路	baishiluwenhualu
儒江	rujiang
马街	majie
杨园	yangyuan
石路	shilu
三里河	sanlihe
书院街	shuyuanjie
龙泽	longze
解放碑	jiefangbei
鹭江	lujiang
瘦西湖	shouxihu
中山门	zhongshanmen
白马北路	baimabeilu
文化宫	wenhuagong
华海3c电脑城	huahai3cdiannaocheng
金花镇	jinhuaqiao
珠江新城	zhujiangxincheng
淳溪	chunxi
广兴	guangxing
大嶝	dadeng
延吉路	yanjilu
妙峰山	miaofengshan
聂寨	niezhai
豫园	yuyuan
南河坝	nanheba
曹杨新村	caoyangxincun
连然	lianran
后坝	houba
右安门	fengtaiyouanmen
渝中周边	yuzhongzhoubian
华蓥山	huayingshan
咸嘉湖	xianjiahu
车轮厂	chelunchang
华新街	huaxinjie
西北	xibei
玉双路	yushuanglu
海滨迟家	haibinchijia
永安路	yonganlu
吉祥路	jixianglu
津头	jintou
商城路	shangchenglu
五里牌	wulipai
华庄	huazhuang
桐梓坡	tongzipo
展览馆	zhanlangguan
东直门	dongzhimen
汉中	hanzhong
南延线	nanyanxian
泰山路	taishanlu
广卫	guangwei
鸿山镇	xinquhongshanzhen
新民路	xinminlu
科园大道	keyuandadao
桤泉	qiquan
芙蓉汉城	furonghancheng
三界	sanjie
高桥	gaoqiao
亚泰大街	yataidajie
芍药居	shaoyaoju
家佳源	jiayuanchang
长凌	zhangling
石家河	shijiahe
临平	linping
广益街道	guangyijiedao
沂蒙三路	yimengsanlu
横店	hengdian
西安大路	xiandalu
光新	guangxin
东新街	dongxin
巴城	bacheng
龙口东	longkoudong
秦岭路	qinlinglu
鄂尔多斯路	eerduosilu
水果湖	shuiguohu
云景路	yunjinglu
长安区政府	zhanganquzhengfu
枣园	zaoyuan
花庄	huazhuang
长江街	changjiang
安慧桥	anhuiqiao
长治路	changzhilu
富春江	fuchunjiang
米山	mishan
启工	qigong
黄台南路	huangtainanlu
东岗西路	donggangxilu
姚寨	yaozhai
陶然路	taoranlu
小观	xiaoguan
天山路	tianshanlu
祁家湾	qijiawan
运河东	yunhedong
食品城	shipincheng
墩子塘	dunzitang
滨河	pinggubinhe
黑石礁	heishijiao
长征	changzheng
火星	huoxing
红桥周边	hongqiaozhoubian
罗村	luocun
渗坝	shenba
黄庄	baodihuangzhuang
龙舟路	longzhoulu
嘉园	jiayuan
上大	shangda
和桥镇	heqiaozhen
太原街	taiyuanjie
黄兴	huangxing
西部通道	xibutongdao
新妙	xinmiao
路官	luguan
青塔	qingta
邦堆	bangdui
省人才	shengrencai
上窑	shangyao
跃龙	yuelong
上尧	shangyao
北兴	beixing
埃德蒙顿路	aidemengdunlu
西苑街区	xiyuanjiequ
福州南路	fuzhounanlu
南寒	nanhan
华南	huananbankuai
春柳河	chunliuhe
北行	beixing
都正街	douzhengjie
黄务	huangwu
新江湾城	xinjiangwancheng
大有恬园	dayoutianyuan
昆明街	kunming
罗八路	luobalu
长埠	zhangbu
海甸	haidian
定慧寺	dinghuisi
赛罕区政府	saihanquzhengfu
道义	daoyi
东四	dongsi
周浦	zhoupu
麻园塘	mayuantang
前进路	qianjinlu
下初	xiachu
东明路	dongminglu
南河	nanhe
金殿片区	jindianpianqu
乌山路	wushanlu
建设街	jianshe
漕河泾	caohejing
月坛	yuetan
流芳	liufang
创业路	chuangyelu
荣业大街	rongyedajie
鼓西	guxi
大连天地	daliantiandi
长虹大道	changhongdadao
大郭	daguo
师范街	shifanjie
嘉禾望岗	jiahewanggang
韭菜园	jiucaiyuan
明珠	mingzhu
石\	shishiqi
左安门	zuoanmen
中华南路	zhonghuananlu
吕田	lvtian
马家滩	majiatan
厦禾路	xiahelu
童家桥	tongjiaqiao
蜜蜂张	mifengzhang
盐步	yanbu
李俊	lijun
马坡	mapo
泗塘	sitang
续迈	xumai
淮西客运站	huaixikeyunzhan
小梅沙	xiaomeisha
西长街	xizhangjie
黄花岗	huanghuagang
奢岭	sheling
朱家角	zhujiajiao
长庆街	changqingjie
上兰	shanglan
侯家营	houjiaying
柳埠镇	liubuzhen
裕南街	yunanjie
九庄	jiuzhuang
邗江工业园	hanjianggongyeyuan
和平广场	hepingguangchang
洪都中大道	hongduzhongdadao
石船	shichuan
小龙坎	xiaolongkan
川师	chuanshi
和平大道	hepingdadao
塔荣	tarong
东环路	donghuanlu
康安路	kangan
诸往	zhuwang
金稻田	jindaotian
海口路	haikoulu
开运街	kaiyunjie
益民	yimin
新村街	xincun
大兴路	daxinglu
龙津	longjin
跃进村	yuejincun
石坪桥	shipingqiao
蒲阳	puyang
泺口	luokou
那洪	nahong
铜罐驿	tongguanyi
金贸	jinmao
太阳宫	taiyanggong
远达	yuanda
公安厅	gonganting
商品街	shangpinjie
东善桥	dongshanqiao
北辰财富中心	beichencaifuzhongxin
区政府	quzhengfu
东渡	dongdu
陈家湖	chenjiahu
花园	pixianhuayuan
火炬村	huojucun
广武门	guangwumen
集庆门	jiqingmen
仙林	xianlin
香炉礁	xianglujiao
远洋城	yuanyangcheng
因民	yinmin
金河	jinhe
小召前街	xiaozhaoqianjie
大营门	dayingmen
湖西路	huxi
乃琼	naiqiong
虹苑路	hongyuanlu
顺和路	shunhelu
秀厢大道	xiuxiangdadao
双塔东西街	shuangtadongxijie
赤岗	chigang
金水东路	jinshuidonglu
隆礼路	longlilu
光谷	guanggu
华阳路	huayanglu
普东	pudong
赤岗冲	chigangchong
御道街	yudaojie
南庄	nanzhuang
辽沈	liaoshen
新圩	xinxu
江西路	jiangxilu
石坪	shiping
杨巷镇	yangxiangzhen
宏远	hongyuan
双街	shuangjie
架桥	jiaqiao
九棵树	jiukeshu
浑河站东	hunhezhandong
广济街	guangjijie
和睦	hemu
崮云湖	guyunhu
那楼	nalou
金海湾	jinhaiwan
陈家坪	chenjiaping
全安	quanan
观澜	guanlan
谈固	tangu
燕庄	yanzhuang
白云大道北	baiyundadaobei
北大路	beidalu
凯旋	kaixuan
树木岭	shumuling
杨柳青	yangliuqing
红岗花园	hongganghuayuan
工人新村北村	gongrenxincunbeicun
东外滩	dongwaitan
阎村	yancun
桥东区政府	qiaodongquzhengfu
沙滨路	shabinlu
小庄	xiaozhuang
黄河汽车站	huangheqichezhan
运河西	yunhexi
八一桥	bayiqiao
汉水桥	hanshuiqiao
沙子口	shazikou
希尔景园	xierjingyuan
张贵庄	zhangguizhuang
江南大道南	jiangnandadaonan
城北乡	chengbeixiang
衙门口	yamenkou
白银路	baiyinlu
崇安寺街道	chongansijiedao
那马	nama
车公庄	chegongzhuang
黑石渡	heishidu
永兴镇	yongxingzhen
老公园	laogongyuan
大李家	dalijia
徐州路	xuzhoulu
工人新村南村	gongrenxincunnancun
北新区	beixinqu
光明路	guangminglu
湖北路	hubeilu
海伦路	hailunlu
阳江	yangjiang
泽头	zetou
三道街	sandaojie
东方路地铁	dongfangluditie
华士镇	huashizhen
书院路	shuyuanlu
牟礼	mouli
定埠	dingbu
光明楼	guangminglou
青岩	qingyan
桃源居	taoyuanju
城南版块	chengnanbankuai
和田街	hetianjie
广阳	guangyang
宝龙城市广场	baolongchengshiguangchang
槐中路	huaizhonglu
龙凤桥	longfengqiao
云纺片区	tuqiao
砖墙	zhuanqiang
古柏	gubai
王寺	wangsi
北新桥	beixinqiao
三桥	sanqiao
大尧	dayao
东辛房	dongxinfang
侯家塘	tianxinhoujiatang
盘龙城	panlongcheng
福明	fuming
莘闵	shenmin
东海西路	donghaixilu
升州路	shengzhoulu
岔路口	chalukou
南熏大道	nanxundadao
丰年村	fengniancun
中山八路	zhongshanbalu
望园路	wangyuanlu
梓园路	ziyuanlu
朝阳湖	chaoyanghu
高梁	gaoliang
地宝	dibao
华洲	huazhou
和义	heyi
合肥路	hefeilu
车站北路	chezhanbeilu
黄土岭	huangtuling
井口	shapingbajingkou
劳动	laodong
灌口	guankou
宣庆	xuanqing
辽河西路	liaohexilu
重工	zhonggong
张庄路	zhangzhuanglu
锦园小区	jinyuanxiaoqu
双路	shuanglu
芥园道	jieyuandao
洪家园	hongjiayuan
沂蒙大楼	yimengdalou
百花洲	baihuazhou
长春理工大学	changchunligongdaxue
热河南路	rehenanlu
百货大楼	baihuodalou
双凤桥	shuangfengqiao
马场	machang
菊园新区	juyuanxinqu
清真巷	qingzhenxiang
沙冲	shachong
小庙	xiaomiao
中原西路	zhongyuanxilu
高塘	gaotang
啤酒城	pijiucheng
建昌道	jianchangdao
胡埭镇	hudaizhen
九水路	jiushuilu
英达	yingda
明湖西路	minghuxilu
新店	xindian
石板滩	shibantan
苘山	qingshan
郝官屯	haoguantun
小井	xiaojing
万里城	wanlicheng
紫竹桥	zizhuqiao
柱山	zhushan
下角	xiajiao
西渚镇	xizhuzhen
江苏路	jiangsulu
西马	xima
河西务	hexiwu
长新街	changxinjie
太平桥	taiping
郝各庄	haogezhuang
兴隆巷	xinglongxiang
47街区	47jiequ
卫星路	weixinglu
啤酒厂	pijiuchang
柑子园	ganziyuan
纸坊	zhifang
舟白	zhoubai
江溪街道	xinqujiangxijiedao
津泰	jintai
西客站	xuanwuxikezhan
五老村	wulaocun
马路湾	maluwan
河西周边	hexizhoubian
古路	gulu
通泰街	tongtaijie
桂林街	guilin
铁路西村	tieluxicun
大南街	dananjie
汊沽港	chagugang
栅山	shanshan
石	shiqi
南塔	nanta
五院	wuyuan
大岗	dagang
京东	jingdong
合庆	heqing
龙桥	longqiao
乌兰察布路	wulanchabulu
安宁堡	anningpu
嵩山路	songshanlu
姜家	jiangjia
阜成门	fuchengmen
石桥铺	shiqiaopu
南街	nanjie
香山	xiangshan
友协	youxie
三和四街	sanhesijie
东环	donghuan
宁海路	ninghailu
周水子	zhoushuizi
市场街	shichangjie
汉中门	hanzhongmen
大光路	daguanglu
福马路	fumalu
南纪门	nanjimen
西兴	xixing
洛羊	luoyang
春申	chunshen
高笋塘	gaosuntang
顺德碧桂园	shundebiguiyuan
洪武路	hongwulu
翠柏路	cuibailu
武胜驿	wushengyi
公平	gongping
滕王阁	tengwangge
下仓	xiacang
中央商务区	zhongyangshangwuqu
市华联	shihualian
罗亭	luoting
刘家桥	liujiaqiao
省军区	shengjunqu
安贞	anzhen
宁波东站	ningbodongzhan
长虹街	changhong
承德广场	donglai
嵩山北路	gaoshanbeilu
水田路	shuitianlu
建新路	jianxinlu
城南路	chengnanlu
南洲	nanzhou
五爱路	wuailu
梁家巷	liangjiaxiang
商鼎路	shangdinglu
上梅林	shangmeilin
开元场	kaiyuanchang
漕宝路	caobaolu
荫子	yinzi
白涛	baitao
花木	huamu
九州	jiuzhou
黄泥川	huangnichuan
西新	xixin
闻堰	wenyan
花城路	huachenglu
祝桥	zhuqiao
尚勤路	shangqinlu
南焦	nanjiao
无影山北路	wuyingshanbeilu
洪广	hongguang
金尚路	jinshanglu
华龙路	hualonglu
较场口	jiaochangkou
茶淀	chadian
郭村	guocun
华泾	huajing
桥头胡	qiaotouhu
隆丰	longfeng
唐岛湾	tangdaowan
磁峰	cifeng
金沙洲	jinshazhou
群力	sidalin
太华镇	taihuazhen
清潭怀德	qingtanhuaide
张家堡	zhangjiabao
工业大道	gongyedadao
中州岛	zhongzhoudao
建设北路	jianshebeilu
淳城	chuncheng
二号桥	erhaoqiao
友新	youxin
杏南路	xingnanlu
鱼化寨	yuhuazhai
淮河路	huaihelu
林和	linhe
乌昌路	wuchanglu
来广营	laiguangying
宋村	songcun
莞城中心	guanchengzhongxin
经十路历下段	jingshilulixiaduan
龙翔	longxiang
王庆坨	wangqingtuo
南门口	nanmenkou
青龙路	qinglonglu
渝碚路	yubeilu
五七	wuqi
文登营	wendengying
二里街	erlijie
石会	shihui
上坊	shangfang
韶存庄	shaocunzhuang
哈西	haxi
田和街区	tianhejiequ
霍各庄	huogezhuang
水贝	shuibei
东蒲洼	dongpuwa
福建园	fujianyuan
新中心区	xinzhongxinqu
卷洞	juandong
子午	ziwu
桠溪	yaxi
竹子林	zhuzilin
下大垅	xiadalong
打浦桥	dapuqiao
船房片区	chuanfangpianqu
福田区委	futianquwei
横涧	hengjian
小埠东	xiaobudong
团结新村	tuanjiexincun
新安街道	xinquxinanjiedao
新石	xinshi
双榆树	shuangyushu
厂前	changqian
清华路	qinghualu
内双楠	neishuangnan
雍华庭	yonghuating
车站	chezhan
牛沙路	lianxin
益田村	yitiancun
光福	guangfu
和平村	taihe
劝业场	quanyechang
焦岱	jiaodai
石化	shihua
双杭	shuanghang
上冲/前山	shangchongqianshan
柴桥	chaiqiao
明城	mingcheng
仓门街	cangmenjie
震泽	zhenze
民生	minsheng
旧县	jiuxian
海上世界	haishangshijie
长乐路	changlelu
七里庄	qilizhuang
大钟寺	dazhongsi
豆张庄	douzhangzhuang
尖岭	jianling
客运总站	keyunzongzhan
海石湾	haishiwan
余杭塘上	yuhangtangshang
东单	dongdan
玉祁镇	yuqizhen
软件园	ruanjianyuan
哈平路	hapinglu
八腊庙街	balamiaojie
城北新区	chengbeixinqu
王顶堤	wangdingdi
白石	baishi
滨河西路	binhexilu
胥口	xukou
山潘	shanpan
顺外路	hufang
高新二路	gaoxinerlu
铁友	tieyou
冉庄	ranzhuang
门巴	menba
六沟垅	liugoulong
惠新里	huixinli
高升小区	gaoshengxiaoqu
关山	guanshan
祖庙	zumiao
南石头	nanshitou
区政府片区	quzhengfupianqu2
黄土坡	huangtupo
象山北路	xiangshanbeilu
工卡	gongka
三其	sanqi
东城天下	dongchengtianxia
云集	yunji
江山路	jiangshanlu
碧谷	bigu
东高村	donggaocun
尤古庄	youguzhuang
西浴场	xiyuchang
通安	tongan
祥平	xiangping
太慈桥	taiciqiao
上大垅	shangdalong
香海小镇	xianghaixiaozhen
王家	wangjia
黄柏	huangbai
柿园	shiyuan
蒲河	puhe
鲲鹏街	kunpengjie
小楼	xiaolou
董场	dongchang
农林下路	nonglinxialu
新安路	xinanlu
北大营	beidaying
洛社镇	luoshezhen
西三旗	xisanqi
武屯	wutun
小行	xiaoxing
五里桥	wuliqiao
桃花	taohua
前卫营	qianweiying
古北	gubei
勤业	qinye
五里店	wulidian
云山	yunshan
周家渡	zhoujiadu
鸿顺里	hongshunli
大桥镇	daqiaozhen
井岗	jinggang
周庄镇	zhouzhuangzhen
当曲卡	dangquka
卫城	weicheng
永松路	yongsonglu
大石坝	dashiba
多巴	duoba
光复北路	guangfubeilu
金山大道	jinshan
环山路	huanshanlu
黄木岗	huangmugang
三道堰	sandaoyan
江心洲	jiangxinzhou
长顺街	shaocheng
桔园小区	juyuanxiaoqu
西岭	xiling
茨竹	wanzhoucizhu
晋原	jinyuan
小港	xiaogang
于洪广场	yuhongguangchang
关上	guanshang
碱泉	jianquan
机投镇	jitouqiao
安徽大学	anhuidaxue
贡元巷	gongyuanxiang
天城	tiancheng
琅琊王路	langyawanglu
金源路	jinyuanlu
无影山中路	wuyingshanzhonglu
应天西路	yingtianxilu
李山东路	lishandonglu
农业东路	nongyedonglu
裕西	yuxi
蒲庙	pumiao
山河	shanhe
松江科技园	songjiangkejiyuan
同志街	tongzhijie
四里村	silicun
花市	huatan
王家湾	wangjiawan
华乐广场	hualeguangchang
经五路	jingwulu
南市	hepingnanshi
地磅	dibang
杨家峪	yangjiayu
白古屯	baigutun
黄岐	huangqi
鳌头	aotou
永商	yongshang
上海影城	shanghaiyingcheng
中大槐树	zhongdahuaishu
礼嘉	lijia
雅玛里克山	yamalikeshan
马鞍路	maanlu
东方红广场	dongfanghong
人民大学	renmindaxue
大观园	daguanyuan
下朱庄	xiazhuzhuang
中山东路	zhongshandonglu
中洲	zhongzhou
文靖路	wenjinglu
昌东	changdong
新仓	xincang
宝塔桥	baotaqiao
日湖公园	rihugongyuan
管城区委	guanchengquwei
竹料	zhuliao
丰台体育馆	fengtaitiyuguan
心圩	xinxu
辽宁路	liaoninglu
三棵树	sanke
沙太北	shataibei
新东区	xindongqu
文星	wenxing
南营门	hepingnanyingmen
算圣巷	suanshengxiang
雅礼中学	yalizhongxue
红星村	hongxingcun
穿芳峪	chuanfangyu
兰园	lanyuan
粮道街	liangdaojie
六道湾	liudaowan
魏家坡	weijiapo
黄河道	huanghedao
识字岭	shiziling
府城	fucheng
老代庄	laodaizhuang
河套	hetao
田地街	tiandijie
陆慕	lumu
冷子堡	lengzipu
南浦路	nanpulu
西站	hezuohuabeilu
荔湾路	liwanlu
扬州大学城	yangzhoudaxuecheng
永清路	yongqinglu
北仓	beicang
曲甫	qufu
涪江二桥	fujiangerqiao
人民广场	renminguangchang
北蔡	beicai
棕树营	zongshuying
即丘路	jiqiulu
锡北	xibei
建外大街	jianwaidajie
华强	huaqiang
清水台	qingshuitai
塔尔	taer
万莲	wanlian
申港街道	shengangjiedao
亚运村	yayuncun
保国	baoguo
汽车南站	qichenanzhan
盘福路	panfulu
伊河路	yihelu
高峰	gaofeng
无影山西路	wuyingshanxilu
吕岭路	lvlinglu
铁西区政府	tiexiquzhengfu
胥家	xujia
南马路	nanma
羊尖	yangjian
容桂	ronggui
甘泉路	ganquanlu
鲁迅公园	luxungongyuan
无影山路	wuyingshanlu
昆仑	kunlun
香积寺路	xiangjisilu
大山洞	dashandong
罗四路	luosilu
彭后	penghou
德化街	dehuajie
华侨路	huaqiaolu
候家沟	houjiagou
天河东路	tianhedonglu
交道口	jiaodaokou
总寨	zongzhai
劳动广场	laodongguangchang
黄花店	huanghuadian
五堡	wupu
大东关	dadongguan
非矿	feikuang
旅游路历下段	lvyoululixiaduan
市府广场	xianqiao
国货	guohuo
安医附院	anyifuyuan
夏湾	xiawan
茶园坡	chayuanpo
北大街	beidajie
广福	guangfu
五里坨	wulituo
北京街	beijing
胜利桥北	shengliqiaobei
科大西区	kedaxiqu
地质中学	dizhizhongxue
成寿寺	chengshousi
华强南	huaqiangnan
枫叶路	fengyelu
金山中部	jinshanzhongbu
上马	shangma
八一市场	bayishichang
马王	mawang
桃园	taoyuan
银峰路	yinfenglu
金洞	jindong
保工	baogong
润宇	runyu
梅岭	meiling
卓达	zhuoda
冼村	tianhexiancun
海富路	haifulu
文化西路	wenhuaxilu
常府街	changfujie
昌国路南段	changguolunanduan
并州南路	bingzhounanlu
富华	fuhua
钟村	zhongcun
凤凰岭	fenghuangling
锦龙	jinlong
钢铁路	gangtielu
沿江	yanjiang
同安路	tonganlu
中街	zhongjie
石鼓路	shigulu
斜土路	xietulu
东大	dongda
大沙	dasha
兴海路	xinghailu
和平大街	hepingdajie
玉泉路	yuquanlu
南七里站	nanqilizhan
八桥	baqiao
第五大街	diwudajie
苇湖梁	weihuliang
和平周边	hepingzhoubian
武阳	wuyang
大红门	dahongmen
青木关	qingmuguan
三和七街	sanheqijie
北站西路	beizhanxilu
光明街	guangmingjie
长椿街	changchunjie
留村	liucun
科技一路	kejiyilu
六榕	liurong
岗集	gangji
骆驼	luotuo
平阳路	pingyanglu
双河口	wanzhoushuanghekou
东林	donglin
l口	biaokou
解放北	jiefangbei
横岗	henggang
顺政路	shunzhenglu
康王路	kangwanglu
图书馆	tushuguan
景星	jingxing
芙蓉中路	furongzhonglu
武昌火车站	wuchanghuochezhan
郑店	zhengdian
桂花岗	guihuagang
金陵镇	jinlingzhen
东柳	dongliu
虎台	hutai
长安周边	zhanganzhoubian
雨花亭	yuhuating
滨湖街道	binhujiedao
知春路	zhichunlu
骊山	lishan
临春河路	linchunhelu
韶山北路	shaoshanbeillu
永平路	yongpinglu
黄海区域	huanghaiquyu
媒体村	meiticun
城西客运站	chengxikeyunzhan
北大清华	beidaqinghua
唐官屯	tangguantun
江都路	jiangdoulu
大润发邗江店	darunfahanjiangdian
荔枝公园	lizhigongyuan
保税区	baoshuiqu
杨家泊	yangjiabo
南湖路	nanhulu
宽城街	liaoyuan
白菊	baiju
后盐	houyan
和平里	hepingli
汤庄	shangzhuang
丝茅冲	simaochong
枫林路	fenglinlu
周新庄	zhouxinzhuang
马家	majia
柴村	chaicun
河南岸	henanan
黄石	huangshi
草甸	caodian
工人村	gongrencun
太白小区	taibaixiaoqu
阳澄湖	yangchenghu
滨海路	binhailu
卡孜	kazi
阜安	fuan
万东	wandong
清和	qinghe
第一师范	diyishifan
西四	xisi
金口路	jinkoulu
江泉酒店	jiangquanjiudian
相思湖新区	xiangsihuxinqu
午极	wuji
平海路	pinghailu
鲁南花卉	lunanhuahui
翟家	zhaijia
水西门	shuiximen
花卉园	huahuiyuan
新场	xinchang
化纤厂路	huaxianchanglu
新庄街道	xinzhuangjiedao
莲花三村	lianhuasancun
东开发区	dongkaifaqu
丰泽商城	fengzeshangcheng
蛟川	jiaochuan
艮山	genshan
苏圃路	supulu
文化宫路	wenhuagonglu
马王堆	mawangdui
江北城	jiangbeicheng
藏雄	cangxiong
北荣街	beirongjie
恒合土家族	henghetujiazu
南莲路	nanlianlu
南桐	nantong
唐园	tangyuan
东工商河路	donggongshanghelu
共富	gongfu
理想新城	lixiangxincheng
杏花村	suixilu
苑东	yuandong
锦泰广场	jintaiguangchang
芦家街	lujia
麦地	maidi
西里	xili
桥头集	qiaotouji
长白新村	zhangbaixincun
大雁塔	dayanta
经十西路	jingshixilu
岔路街	chalujie
西丽	xili
唐元	tangyuan
五里墩	wulidun
许坦东西街	xutandongxijie
孙文东路	sunwendonglu
五里堆	wulidui
志华商城	zhihuashangcheng
艾维尔沟	aiweiergou
张渚镇	zhangzhuzhen
石油大学	shiyoudaxue
万家丽	wanjiali
新华医院	xinhuayiyuan
潘家园	panjiayuan
悦来	yuelai
员村二横路	yuancunerhenglu
东北大马路	dongbeidamalu
常青	changqing
拓东	tuodong
马家堡	majiabao
五百户	wubaihu
石岛区	shidaoqu
御营坝	yuyingba
骆岗	luogang
英雄山路	yingxiongshanlu
麻柳沱	maliutuo
旅顺北路	lvshunbeilu
白涧	baijian
土湾	tuwan
玄武湖	xuanwuhu
玲珑	linglong
健康街	jiankangjie
太平南路	taipingnanlu
苏家	sujia
府南新区	funan
白沙大道	baishadadao
兴华路	xinghualu
葛仙山	gexianshan
大碱厂	dajianchang
松北	songbei1
茶店子	chadianzi
芙蓉苑	furongyuan
西来	xilai
高新四路	gaoxinsilu
建设大道	jianshedadao
福州北路	fuzhoubeilu
园艺山	yuanyishan
白鹭花园	bailuhuayuan
环市东	huanshidong
赵巷	zhaoxiang
招宝山	zhaobaoshan
大划	dahua
李集	liji
跳蹬河	tiaodenghe
大华	dahua
解放中路	jiefangzhonglu
春光路	chunguanglu
沙尾	shawei
拱北	gongbei
靖江路	jingjianglu
钱桥街道	qianqiaojiedao
牙膏厂	yagaochang
石纺路	shifanglu
桂林路	guilin
大毕庄	dabizhuang
周市	zhoushi
五角场	wujiaochang
新安江	xinanjiang
二中学区	erzhongxuequ
新庄	xinzhuang
扬州汽车站	yangzhouqichezhan
前洲镇	qianzhouzhen
六角亭	liujiaoting
梅庄	meizhuang
洪都北大道	hongdubeidadao
石沱	shituo
平治街	pingzhijie
旧宫	jiugong
泉园	quanyuan
沙河源	shaheyuan
阳逻	yangluo
太乙宫	taiyigong
利民开发区	liminkaifaqu
河松	hesong
白羊	baiyang
新溉路	xingailu
相公	xianggong
方家栏	fangjialan
复兴门	fuxingmen
浏正街	liuzhengjie
崇明新城	chongmingxincheng
将军大道	jiangjundadao
花岗	huagang
斑竹园	banzhuyuan
安澜	anlan
明月	mingyue
酒仙桥	jiuxianqiao
南彭	nanpeng
四季青	sijiqing
新闻大厦	xinwendasha
玄武门	xuanwumen
罗七路	luoqilu
王串场	wangchuanchang
奥运村	aoyuncun
谢家湾	xiejiawan
华林坪	hualinping
古美罗阳	gumeiluoyang
十里堡	miyunshilipu
棘洪滩	jihongtan
涂家冲	tujiachong
苇湾	weiwan
瀛洲	yingzhou
赤岭路	chilinglu
和平西路	hepingxilu
唐家湾	tangjiawan
一碗水	yiwanshui
杨浦公园	yangpugongyuan
财富广场	caifuguangchang
湖景	hujing
百花中心站	baihuazhongxinzhan
丹东	dandong
雪浪街道	xuelangjiedao
富湾	fuwan
小林子冲	xiaolinzichong
南内环	nanneihuan
体育馆	tiyuguan
盐市口	yanshikou
跳伞塔	tiaosanta
三和六街	sanheliujie
窦店	doudian
八角	bajiao
宏大路	hongdalu
林岗	lingang
军博	junbo
路南	lunan1
仲宫	zhonggong
何家村	hejiacun
青秀山	qingxiushan
七星桃源区	qixingtaoyuanqu
八街	bajie
鹅池	echi
义堂	yitang
别山	bieshan
翻身路	fanshenlu
燕儿岛路	yanerdaolu
春城大街	chuncheng
泉城路	quanchenglu
马池口	machikou
海景御花园	haijingyuhuayuan
黄桥	huangqiao
标山路	biaoshanlu
义乌商品城	yiwushangpincheng
南蔡村	nancaicun
百善	baishan
五里	wuli
中和	zhonghe
东关屯	dongguantun
鼓浪屿	gulangyu
天心阁	tianxinge
中河	zhonghe
团山	tuanshan
淘金	taojin
金泉	jinquan
柏家沟	baijiagou
海滩街	haitanjie
西湖路	xihulu
赵公口	zhaogongkou
义和	yihe
广园路	guangyuanlu
北京东路	beijingdonglu
岳寨	yuezhai
南茶坊	nanchafang
光塔	guangta
中韩	zhonghan
镇龙	zhenlong
五大花园	jinyang
新开河	xinkaihe
客村	kecun
洋泾	yangjing
东华	donghua
科技园	kejiyuan
铁厂	tiechang
段庄广场	duanzhuangguangchang
牛耳桥	niuerqiao
解放大路	jiefangdalu
景阳	jingyang
木耳	muer
花园白云	huayuanbaiyun
阳翟路	yangzhailu
走马岭	zoumaling
国兴	guoxing
杨桥路	yangqiaolu
34中	34zhong
大望路	xidawanglu
七里站	qilizhan
庄桥	zhuangqiao
步行街	buxingjie
聂唐	nietang
青岛大学	qingdaodaxue
大潘镇	dapanzhen
金沙江路	jinshajianglu
凌霄路	lingxiaolu
胡家庙	hujiamiao
黎明路	liminglu
西五路	xiwulu
钟家村	zhongjiacun
徐霞客镇	xuxiakezhen
东里	dongli
凤凰路	fenghuanglu
开元路	kaiyuanlu
段店北路	duandianbeilu
施古	shigu
出头岭	chutouling
四川北路	sichuanbeilu
新花	qianjiangxinhua
柳沙片区	liushapianqu
济泺路	jiluolu
嘉定城区	jiading1
老西门	laoximen
低塘	ditang
三好街	sanhaojie
向工	xianggong
新沟桥	xingouqiao
花冲公园	huachonggongyuan
冯家	fengjia
工人文化宫	wenhua
双桂路	shuangguilu
孙坂路	sunbanlu
江厦	jiangxia
转龙	zhuanlong
蔡锷南路	caienanlu
潮海	chaohai
黑林铺	heilinpu
府东府西	fudongfuxi
实验中学	shiyanzhongxue
高城山	gaochengshan
互助路立交	huzhululijiao
滨河东路	binhedonglu
世界公园	shijiegongyuan
铁西广场	tiexiguangchang
人民路	renminlu
鱼嘴	yuzui
杨浦大桥	yangpudaqiao
城乡路	chengxianglu
洪家楼	hongjialou
肖坝	xiaoba
罗冲围	luochongwei
吉大	jida
虎山路	hushanlu
迎泽西大街	yingzexidajie
桥华世纪村	qiaohuashijicun
临西九路	linxijiulu
卡如	karu
白石桥	baishiqiao
电子正街	dianzizhengjie
塘汛	tangxun
虎溪	huxi
蠡园	liyuan
星海广场	xinghaiguangchang
古彭广场	gupengguangchang
土门	tumen
太平广场	taipingguangchang
杨庙	yangmiao
香港东路	xianggangdonglu
工业大道南	gongyedadaonan
银湖	yinhu
芙蓉周边	furongzhoubian
东高地	donggaodi
甘宁	ganning
沈家坝	chenjiaba
人民医院	renminyiyuan
积水潭	jishuitan
伶俐镇	linglizhen
滨河大道	binhedadao
东北塘	dongbeitang
CBD	CBD
固城	gucheng
晏家	yanjia
蒿泊	haobo
历山北路	lishanbeilu
自强街	ziqiang
桂花	guihua
临河里	linheli
西广场	xiguang
八里小区	taoqilu
解放广场	jiefangguangchang
莲花片区	lianhua
南京西路	nanjingxilu
财落	cailuo
望麓园	wangluyuan
司门口	simenkou
南湖南路	nanhunanlu
万寿路	wanshoulu
大孤山	dagushan
三和二街	sanheerjie
清溪路	qingxilu
西于庄	xiyuzhuang
新螺蛳湾	xinluosiwan
陈官屯	chenguantun
中央门	zhongyangmen
邓双	dengshuang
七都	qidu
莲前西路	lianqianxilu
九洲大道	jiuzhoudadao
丰荣	fengrong
西藏南路	xizangnanlu
红阳	hongyang
罗云	luoyun
寿安	wenjiangshouan
孝友路	xiaoyoulu
陈家桥	chenjiaqiao
安镇	anzhen
一曼街	yimanjie
城东湖	chengdonghu
中山南路	zhongshannanlu
一元路	yiyuan
双柳	shuangliu
崇文门	chongwenmen
双龙	shuanglong
中云	zhongyun
左岭	zuoling
沂蒙五路	yimengwulu
南天	nantian
芳桥镇	fangqiaozhen
闽江	minjiang
国际会展中心	guojihuizhanzhongxin
建国街	jianguojie
唐镇	tangzhen
高刘	gaoliu
石老人	shilaoren
滇池路片区	fuhai
大黄堡	dahuangpu
兴南街	xingnan
丰润	fengrun1
丽臣路	lichenlu
庙前	miaoqian
易家墩	qiaokouyouyidadao
下塘	xiatang
嘉禾路	jiahelu
安居路	anjulu
中铁四局	zhongtiesiju
康健	kangjian
新广场	xinguangchang
建政	jianzheng
兴隆路	xinglonglu
世纪大街	shijidajie
北一路	beiyilu
早化	zaohua
海棠路	haitanglu
菜市口	caishikou
娄葑	loufeng
柠溪	ningxi
俄黄路	ehuanglu
警钟街	jingzhongjie
江东门	jiangdongmen
新宫	xingong
嘉莲	jialian
并州北路	bingzhoubeilu
口东	koudong
派潭	paitan
苗庄	miaozhuang
八宝山	babaoshan
黄水	huangshui
鼓楼巷	gulouxiang
共康	gongkang
星火	xinghuo
华山	huashan
鲁谷	lugu
流花	liuhua
南滩	nantan
徐家湾	xujiawan
堤口路	dikoulu
农讲所	nongjiangsuo
天心区政府	tianxinquzhengfu
长通路	changtong
四微	siwei
世博滨江	pudongshibobinjiang
磁窑堡	ciyaobao
西二旗	xierqi
凤凰台	fenghuangtai
四唯	siwei
观前	guanqian
福和	fuhe
回龙观	huilongguan
九渡河	jiuduhe
洋桥	yangqiao
学堂	xuetang
滨河路	binhelu
德雅路口	deyalukou
祝丘路	zhuqiulu
御临	yulin
杨津庄	yangjinzhuang
云亭镇	yuntingzhen
亳州路	bozhoulu
洛阳路	luoyanglu
乐甲	lejia
南部新城	nanbuxincheng
南川西路	nanchuanxilu
花源	xinjinhuayuan
胥江	xujiang
煎茶	jiancha
会展中心	huizhanzhongxin
六里村	liulicun
滦镇	luanzhen
朱加	zhujia
松岭路	songlinglu
民航路	minhanglu
白鹅潭	baietan
体育馆路	tiyuguanlu
瑞昌路	ruichanglu
南口	nankou
蒙山大道	mengshandadao
市中区	shizhongqu
滂江街	guancheng
水清沟	shuiqinggou
广厦新村	guangshaxincun
威海路	weihailu
同里	tongli
北二路	dugong
儿童医院	ertongyiyuan
七里庙	qilimiao
营盘路	yingpanlu
建设	jianshe
弘海	honghai
郝庄	haozhuang
客车厂	kechechang
格达	geda
常营	changying
粮道	liangdao
东北师大	dongbeishida
体育路	tiyulu
七里堡	qilibao
罗湖区委	luohuquwei
世博广场	shiboguangchang
宜川路	yichuanlu
松桂园	songguiyuan
庙岭	miaoling
拥政	yongzheng
九佛	jiufo
海军广场	haijunguangchang
三洞桥	sandongqiao
徐家	xujia
官林镇	guanlinzhen
同乐	tongle
辽阳街	liaoyangjie
迎春街	yingchunjie
德胜	desheng
南坨子	nantuozi
东关	dongguan
辽滨	liaobin
同德围	tongdewei
朝阳路	chaoyanglu
浏阳河	liuyanghe
土城	tucheng
坑口	kengkou
冠县路	guanxianlu
杨家村	yangjiacun
甘丹曲果	gandanquguo
和平路	hepinglu
先进	xianjin
八一路	bayilu
兴隆台锡伯族	xinglongtai
唐延路	tangyanlu
沂蒙四路	yimengsilu
安村	ancun
歌乐山	shapingbageleshan
白玉山	baiyushan
闸弄口	zhanongkou
庙行	miaohang
民主广场	minzhuguangchang
伦教	lunjiao
笋岗	sungang
促进路	cujinlu
荷叶地	heyedi
果戈里	guogeli
蔡公庄	caigongzhuang
和泰新城	hetaixincheng
顾乡	gongnong
五里沟	wuligou
小北	xiaobei
热河路	rehelu
香蜜湖	xiangmihu
四方坪	sifangping
上仓	shangcang
金门路	jinmenlu
欧家坝	oujiaba
尧化	yaohua
万江中心	wanjiangzhongxin
莲坂	lianban
丁蜀镇	dingshuzhen
杨公桥	yanggongqiao
东大街	dongdajie
大丰堆	dafengdui
青霞	qingxia
文港	wengang
芦台经济开发区	lutaijingjikaifaqu
留营	liuying
火车西站	huochexizhan
金水桥	jinshuiqiao
上步	shangbu
三里村	sanlicun
帝湖	dihu
刘家堡	liujiapu
胜利街	shengli
汾江南路	fenjiangnanlu
珍溪	zhenxi
万春	wanchun
麓谷	lugu
环市西	huanshixi
霍营	huoying
武侯祠大街	wuhoucidajie
天元帝景	tianyuandijing
杨家山	yangjiashan
于洪区委	yuhongquwei
苏锦	sujin
新柳路	xinliulu
市中医院	shizhongyiyuan
文昌阁	wenchangge
西影路	xiyinglu
团结	tuanjie
西柳沟	xiliugou
麻丘	maqiu
钟公庙	zhonggongmiao
高营	gaoying
太宁路口	taininglukou
乌鲁隆	wululong
二环东路南段	erhuandonglunanduan
新矸	xingan
三和三街	sanhesanjie
唯亭	weiting
沙头	shatou
龙潭公园	longtangongyuan
径河	jinghe
洪塘	hongtang
高新周边	gaoxinzhoubian
汽车厂区	qichechangqu
阿弥岭	amiling
鄂尔多斯东街	eerduosidongjie
西大街	xidajie
平安北大街	pinganbeidajie
虎丘	jinchanghuqiu
世达广场	shidaguangchang
渡舟	duzhou
金箔路	jinbolu
宝泉路	baoquanlu
龙都	longdu
崇山	chongshan
太安	taian
西溪	xixi
于家房	yujiafang
西兆通	xizhaotong
龙潭	longtan
桃源街	taoyuan
海东路	haidonglu
牛王庙	niuwangmiao
莲花二村	lianhuaercun
曙光路	shuguang
小雁塔	xiaoyanta
小周	xiaozhou
新河街	xinhe
西安广场	xianguangchang
通道街	tongdaojie
崔黄口	cuihuangkou
十二路	shierlu
连江南路	lianjiangnanlu
陶瓷城	taocic
平阳街	pingyangjie
工业大道中	gongyedadaozhong
农业园区	nongyeyuanqu
环城	huancheng
望湖城	wanghucheng
王连	wanglian
梅厂	meichang
秣陵	moling
西南	xinan
荣巷	rongxiang
威坪	weiping
安昌桥	anchangqiao
红城	hongcheng
新客站	xinkezhan
望春	wangchun
雍和宫	yonghegong
山窝	shanwo
三工	sangong
山大南路	shandananlu
竹山园	zhushanyuan
松昌	songchang
布吉	buji
潘家坪	panjiaping
陵东	lingdong
汤丹	tangdan
实验小学	shiyanxiaoxue
白家	baijia
北新道八方	beixindaobafang
圭塘	guitang
坝陵桥	balingqiao
撮镇	cuozhen
马桥	maqiao
荷花坑	hehuakeng
云合	yunhe
草场街	caochangjie
翠湖	cuihu
万石镇	wanshizhen
肖寨门	xiaozhaimen
通河新村	tonghexincun
白广路	baiguanglu
合工大	hegongda
大溪沟	daxigou
长阳路	zhangyanglu
迎春大街	yingchundajie
双桥路	shuangqiaolu
赵镇	zhaozhen
安西	anxi
跳磴	tiaodeng
梧村	wucun
牛道口	niudaokou
大差市	dachashi
汤头	shangtou
袁家岗	yuanjiagang
宁中	ningzhong
董家窑	dongjiayao
北太平庄	beitaipingzhuang
青山湖大道	tangshan
江东科技园区	jiangdongkejiyuanqu
安徽农业大学	anhuinongyedaxue
十陵	shiling
黄岗路	huangganglu
东风东路	dongfengdonglu
龙岗中心城	longgangzhongxincheng
甘溪	ganxi
温泉公园	wenquangongyuan
大冲	dachong
苏圩	suxu
房山城关	fangshanchengguan
中山广场	yuanlu
三面船	sanmianchuan
振华路	zhenhualu
东瓦窑	dongwayao
明水路	mingshuilu
盖家沟	gaijiagou
东风东	dongfengdong
公园	gongyuan
友爱	youai
江西	jiangxi
大马路	damalu
祝甸	zhudian
晏家坪	yanjiaping
罗泾	luojing
鹅湖	ehu
通伸	tongshen
第二大街	dierdajie
格林小镇	gelinxiaozhen
萝岗镇	luogangzhen
港西	gangxi
购物公园	gouwugongyuan
杏北路	xingbeilu
甲玛	jiama
德胜门	deshengmen
邾城	zhucheng
普子	wanzhoupuzi
雁栖	yanqi
西花园路	xihuayuanlu
洞泾	dongjing
江北周边	jiangbeizhoubian
康桥	kangqiao
省人防办	shengrenfangban
彭城广场	pengchengguangchang
怀北	huaibei
工农路	gongnonglu
奋斗	fendou
兰山路	lanshanlu
三八广场	sanbaguangchang
什刹海	shichahai
沧林路	canglinlu
江燕路	jiangyanlu
彭镇	pengzhen
天竺	tianzhu
曹家渡	caojiadu
新兴街	xinxing
金胜	jinsheng
嘉兴	jiaxing
溪霞	xixia
津塘路	jintanglu
杏林	xinglin
新镇	xinzhen
堡子	fulingpuzi
白龙	bailong
登沙河	dengshahe
彭岗	penggang
前门	chongwenqianmen
农业路	nongyelu
塘沽周边	tangguzhoubian
殿前	dianqian
中华	zhonghua
葛大店	gedadian
籍田	jitian
东站	dongzhan
晋祠	jinci
温州商贸城	wenzhoushangmaocheng
南岸周边	nananzhoubian
大寺	dasi
板仓	bancang
平安路	pinganlu
航天桥	hangtianqiao
桃花坞	taohuawu
洪河	honghe
犀浦	xipu
二七新村	erqixincun
龙凤苑	longfengyuan
石岗	shigang
解放南	jiefangnan
西宫	xigong
北正街	beizhengjie
齐贤	qixian
振兴街	zhenxingjie
官亭	guanting
潜龙花园	qianlonghuayuan
太乙路	taiyilu
续普	xupu
工业北路	gongyebeilu
东嘎	duilongdeqingdongga
北古城	beigucheng
柳影路	liuying
下营	xiaying
华漕	huacao
东岗	donggangsjz
下应	xiaying
西善桥	xishanqiao
中天路	zhongtianlu
浆洗街	jiangxijie
郎茂山	langmaoshan
簇桥	cuqiao
春华街	chunhua
泰华街	taihuajie
五四广场	wusiguangchang
马乡	maxiang
莲池小学	lianchixiaoxue
小西天	xiaoxitian
土门墩	tumendun
聚才路	jucailu
黄沙溪	huangshaxi
大寨	dazhai
运动系	yundongxi
西关	xiguan
新迎片区	xinyingpianqu
荔枝	lizhi
唐嘎	tangga
新竹	xinzhu
莘庄	shenzhuang
江南大道中	jiangnandadaozhong
南直路	nanzhilu
京华城	jinghuacheng
大圩	daxu
p滨路	fangbinlu
小白楼	xiaobailou
蜀汉路	shuhanlu
沧口体育场	cangkoutiyuchang
坡子街	pozijie
濯西	zhuoxi
新桥	xinqiao
澄江街道	chengjiangjiedao
湖南商学院	hunanshangxueyuan
天拖南	tiantuonan
西新桥	xixinqiao
药六	yaoliu
延安大路	yanandalu
长安路	zhanganlu
健翔桥	jianxiangqiao
广场南路	guangchangnanlu
新南门	duyuanjie
辛庄	xinzhuang
杨家坪	yangjiaping
柳花泊	liuhuabo
新华路南	xinhualunan
建政街道	jianzhengjiedao
杨行	yanghang
小站	xiaozhan
三阳路	sanyanglu
圣水青义	shengshuiqingyi
桥南	qiaonan
王稳庄	wangwenzhuang
新闸路	xinzhalu
北四路	beisilu
石道街	shidaojie
五里河	wulihe
谈固大街	tangudajie
上海南站	shanghainanzhan
大山子	dashanzi
梯面	timian
中央大街	zhongyangdajie
白龙路片区	bailonglupianqu
笕桥	jianqiao
寨子	zhaizi
世纪公园	shijigongyuan
穷达	qiongda
河西路	hexilu
洪城路	hongchenglu
章多	zhangduo
绿波	lvbo
罗汉寺	luohansi
羊昌	yangchang
长滩	changtan
海棠溪	haitangxi
三汊河	sanchahe
候家	houjia
宽平大路	kuanping
彭家桥	pengjiaqiao
定淮门	dinghuaimen
建国公园	jianguo
大周	dazhou
龙洞堡	longdongbao
和平门	hepingmen
商代遗址	shangdaiyizhi
万达	wanda
官仓	guancang
石牌	shipai
吉林	jilin
中山公园	zhongshangongyuan
夏官营	xiaguanying
城市广场	chengshiguangchang
板桥	banqiao
黄龙溪	huanglongxi
宝山路	baoshanlu
八里堡	balipu
陈村	chencun
北环商城	shengli
旅游路高新段	lvyoulugaoxinduan
苍霞	cangxia
沈辽路	yuhongshenliaolu
春草路	chuncaolu
陈塘庄	chentangzhuang
赛马场	saimachang
榆林	yulin
台东	taidong
高何	gaohe
东明路南段	dongminglunanduan
马群	maqun
稻香村	daoxiangcun
上清寺	shangqingsi
湖西	huxi
吴庄花园	wuzhuanghuayuan
长延堡	zhangyanbao
黄贝岭	huangbeiling
舜玉路	shunyulu
河北屯	hebeitun
仓埠	cangbu
球场街	qiuchang
天马	tianma
八达岭	badaling
泉水	quanshui
景芳	jingfang
劳动路	laodonglu
十六里河	shiliulihe
巴燕	bayan
经二路	jingerlu
金汇	jinhui
红梅	hongmei
蔡锷北路	caiebeilu
浦东外环	pudongwaihuan
嘉定山	jiadingshan
建康路	jiankanglu
上海路	shanghailu
沙坪坝周边	shapingbazhoubian
两路	lianglu
侯台	houtai
国贸中心	guomaozhongxin
环城南路	huanchengnanlu
幸福e家	xingfuejia
京溪	jingxi
金龙	jinlong
王泗	wangsi
北市	beishi
均禾	junhe
南海大道北	nanhaidadaobei
临园口	linyuankou
竹苑	zhuyuan
黑龙江街	heilongjiang
五爱市场	wuaishichang
同和	tonghe
官洲	guanzhou
洮昌	taochang
湘江道	xiangjiangdao
小桥	xiaoqiao
贵和	guihe
咸嘉新村	xianjiaxincun
百子湾	baiziwan
李家沱	lijiatuo
东城中心	dongchengzhongxin
泗泾	sijing
茶巴朗	chabalang
北工大	beigongda
西五	xiwu
汝河西路	ruhexilu
艳山红	yanshanhong
花园小区	huayuanxiaoqu
双塘	shuangtang
长风新村	zhangfengxincun
向塘	xiangtang
常州道	changzhoudao
工学院	gongxueyuan
铭功路	minggonglu
老鳖湾	laobiewan
金乔	jinqiao
茶巴拉	chabala
安西街	anxijie
车陂	chebei
通天	tongtian
府后街	fuhoujie
抚顺	fushun
天星寺	tianxingsi
石园	shiyuan
南线	nanxian
天府	tianfu
长虹路	changhonglu
复旦大学	fudandaxue
光复路	guangfulu
省体中心	shengtizhongxin
夏港街道	xiagangjiedao
雅瑶	yayao
清河北路	qinghebeilu
红星路	hongxinglu
汀溪	tingxi
固驿	guyi
白鹤洞	baihedong
双定镇	shuangdingzhen
胜南	shengnan
湘湖路	xianghulu
大水泊	dashuibo
水市	shuishi
福华街	fuhuajie
王家冲	wangjiachong
南晓	nanxiao
复盛	fusheng
湖父镇	hufuzhen
西关什字	xiguanshizi
湘雅路口	xiangyalukou
龙首村	longshoucun
建国路	jianguolu
中泽国货	zhongzeguohuo
沈牌子	shenpaizi
汪疃	wangtuan
狮山	shishan
姚家园	yaojiayuan
王兆	wangzhao
市政府	shizhengfu
天河客运站	tianhekeyunzhan
南翔	nanxiang
东社	dongshe
蔡家岗	caijiagang
九堡	jiupu
广花	guanghua
独流	duliu
碧鸡	biji
厦港	xiagang
通达南路	tongdananlu
南彩	nancai
建设广场	jiansheguangchang
解放路	jiefanglu
马鞍池	maanchi
朱昌	zhuchang
鸿城	hongcheng
珞狮南路	luoshinanlu
竹篙	zhugao
羊安	yangan
机床二厂路	jichuangerchanglu
水西沟	shuixigou
南屏街片区	huguo
金中	jinzhong
龙口西	longkouxi
德雅村	deyacun
新汽车站	xinqichezhan
万宝街	wanbaojie
农大	nongda
李七庄	liqizhuang
黄田坝	huangtianba
郭家沱	guojiatuo
涑堤路	sudilu
新兴广场	xinxingguangchang
文化东路	wenhuadonglu
东朝阳路	dongchaoyanglu
大盛	dasheng
航空路	hangkonglu
二环路	erhuanlu
武夷花园	wuyihuayuan
金竹	xiaohejinzhu
二七广场	erqiguangchang
大石	dashi
中丘路	zhongqiulu
长客	changke
金银湖	jinyinhu
西槎路	xicuolu
世茂大道	shimaodadao
红光	hongguang
宝林	baolin
长陵	changling
博物馆	bowuguan
吴泾	wujing
海琴广场	haiqinguangchang
天山海世界	tianshanhaishijie
西营门	xiyingmen
元洪城	yuanhongcheng
下吕浦	xialvpu
浦珠路	puzhulu
汽车站	qichezhan
留医部	liuyibu
官扎营	guanzhaying
三元里	sanyuanli
百江	baijiang
工电路	gongdianlu
大王家巷	dawangjiaxiang
中华中路	zhonghuazhonglu
西厂门	xichangmen
晓庄	xiaozhuang
营市街	yingshijie
黄桷坪	huangjueping
宝龙	baolong
荔联	lilian
五塘	wutang
马喇	mala
大墅	dashu
天伦广场	tianlunguangchang
西渡	xidu
西园	xiyuan
西堤头	xiditou
义兴	yixing
阳光新路	yangguangxinlu
天佑	tianyou
水西关	shuixiguan
蒲花	puhua
南海广场	nanhaiguangchang
临西十路	linxishilu
劳动中路	laodongzhonglu
止马营	zhimaying
雁滩	yantan
西市场	xishichang
东兴路	dongxinglu
南苑街	nanyuanjie
旁多	pangduo
高埂	gaogeng
三和东街	sanhedongjie
八颗	bake
前进大街	qianjindajie
人民南	renminnan
和盛	hesheng
水库	shuiku
万顷沙	wanqingsha
孙家	sunjia
文化路	wenhualu
前进街	qianjinjie
柏树林	baishulin
双东坊	shuangdongfang
罗五路	luowulu
大钟庄	dazhongzhuang
礼明庄	limingzhuang
大连湾	dalianwan
三官庙	sanguanmiao
西香坊	xixiangfang
景山小区	jingshanxiaoqu
车家村	chejiacun
大椿桥	dachunqiao
美食街	meishijie
水口	shuikou
双墩	shuangdun
丁字桥	dingziqiao
安宁东路	anningdonglu
岳麓周边	yueluzhoubian
清江	qingjiang
杨家群	yangjiaqun
自强路	ziqianglu
红旗渠	hongqiqu
大\	daqi
郑旺	zhengwang
桥北	qiaobei
翟营	zhaiying
张家产	zhangjiachan
伊春路	yichunlu
湖东路	hudonglu
香港中路	xianggangzhonglu
大马村	damacun
园岭	yuanling
涑河北路	suhebeilu
系马桩	ximazhuang
西永	xiyong
玛克威	chongjian
东关街	dongguanjie
东圃	dongpu
皂君庙	zaojunmiao
昆阳	kunyang
第一大街	diyidajie
灯市口	dengshikou
平谷镇	pingguzhen
拱宸桥	gongchenqiao
东屏	dongping
嵩屿码头	songyumatou
光社	guangshe
珠海	zhuhai
阳山镇	yangshanzhen
顺城街	shunchengjie
八大关	badaguan
隆盛	longsheng
海运仓	haiyuncang
万兴街	wanxing
东苑	dongyuan
青果山	qingguoshan
开福寺	kaifusi
白山路	baishanlu
中远两湾城	zhongyuanliangwancheng
石祥路	shixianglu
武泰闸	wutaizha
长乐坊	zhanglefang
新大桥	xindaqiao
航海东路	hanghaidonglu
茶园新区	chayuanxinqu
观音桥	guanyinqiao
吴门桥	wumenqiao
庄墓	zhuangmu
昙华寺片区	tanhuasipianqu
大营盘	dayingpan
坂田	bantian
前坊	qianfang
葛家	gejia
下窑	xiayao
熊家	xiongjia
安德	ande
程家桥	chengjiaqiao
斥山区	chishanqu
泺源	luoyuan
万柳	wanliu
北滨路	beibinlu
长风街	changfengjie
吴山	wushan
火车南站	huochenanzhan
海秀	haixiu
龙池	longchi
浦沿	puyan
西固城	xigucheng
上三路	shangsanlu
淮海路	huaihailu
黎水	lishui
禾祥西路	hexiangxilu
大学东路	daxuedonglu
云岗	yungang
逢源商业街	fengyuanshangyejie
小天竺	xiaotianzhu
中山大道	zhongshandadao
龙潭路	longtanlu
碧沙岗	bishagang
新城东街	xinchengdongjie
燕子山路	yanzishanlu
官庄	guanzhuang
大唐世家	datangshijia
西翟庄	xizhaizhuang
朝外	chaowai
关坝	guanba
梓园路口	ziyuanlukou
中华北路	zhonghuabeilu
夫子庙	fuzimiao
宗关	zongguan
黄埭	huangdai
梅林关口	meilinguankou
周家嘴路	yangpuzhoujiazuilu
丰宁片区	fengning
安宁南路	anningnanlu
德源	deyuan
土主	tuzhu
北小辛庄	beixiaoxinzhuang
大南门	dananmen
北淮淀	beihuaidian
建国门	jianguomen
光复道	guangfudao
丁香湖	dingxianghu
海滨路	haibinlu
如多	ruduo
邻封	linfeng
仓前	cangqian
中医院	zhongyiyuan
凌云路	lingyunlu
水上公园	shuishanggongyuan
临泉东路	linquandonglu
古荡	gudang
青山路	qingshanlu
三孔桥街	sankongqiaojie
锦程	jincheng
创业大街	chuangyedajie
群英	qunying
白石洲	baishizhou
数码广场	shumaguangchang
魏公村	weigongcun
太极	taiji
东丽周边	donglizhoubian
高水	gaoshui
云岭路	yunlinglu
南中环	nanzhonghuan
后溪	houxi
八卦岭	bagualing
杏坛	xingtan
独墅湖	dushuhu
滇池度假区	dianchidujiaqu
于洪新城	yuhongxincheng
跳石	tiaoshi
南新路口	nanxinlukou
亭江	tingjiang
建设大路	jianshedalu
八达路	badalu
扎雪	zhaxue
复洲城	fuzhoucheng
罗沙	luosha
开平路	kaipinglu
东风西	dongfengxi
小汤山	xiaotangshan
普松	pusong
五象广场	wuxiangguangchang
砚瓦池	yanwachi
环城路	huanchenglu
砚池街	yanchijie
柏林四季	bolinsiji
北站东路	beizhandonglu
友谊大道	qingshanyouyidadao
车公庙	chegongmiao
北院门	beiyuanmen
白沙淮	baishahuai
庙后街	miaohoujie
新城区政府	xinchengquzhengfu
金融街	jinrongjie
黄阁	huangge
火炬路	huojulu
日新	rixin
明阳路	mingyanglu
管庄	guanzhuang
丁公路	dinggonglu
毫沁营	haoqinying
东风大街	dongfeng
中华门	zhonghuamen
白沙洲	baishazhou
春熙路	chunxilu
桑梓	sangzi
月城镇	yuechengzhen
瑞宝	ruibao
文体西路	wentixilu
桐柏路	tongbailu
沂河路	yihelu
兰埔	lanpu
乳山市区	rushanshiqu
梨园	liyuan
城西版块	chengxibankuai
五中家乐福	wuzhongjialefu
勒流	leliu
羊亭	yangting
岭南大道	lingnandadao
塔吉	taji
青泥洼桥	qingni
茨榆坨	ciyutuo
韩家墩	hanjiadun
江南中	jiangnanzhong
开发东区	kaifadongqu
奥林匹克广场	aolinpike
北城区	beichengqu
科技园区	kejiyuanqu
南华西	nanhuaxi
赵陵铺	zhaolingpu
华北路	huabeilushk
餮	mengyang
复兴中路	fuxingzhonglu
第一津街	diyijinjie
湖滨东路	hubindonglu
红岛	hongdao
平安南大街	pingannandajie
文灶	wenzao
大竹林	dazhulin
丰盛	fengsheng
胜利	shengli
牌楼路	pailoulu
外双楠	shuangnan
陶然亭	taoranting
珲春街	huichunjie
初家	chujia
马三家	masanjia
八大处	badachu
伍仙桥	wuxianqiao
福新中路	fuxinzhonglu
f直	luzhi
城东版块	chengdongbankuai
洞井铺	dongjingpu
交大	jiaoda
新华大街	xinhuadajie
天通苑	tiantongyuan
大明路	daminglu
沙坝	shaba
留园	liuyuan
江苏路地铁	jiangsuluditie
东广场	dongguang
长淮	changhuai
联丰路	lianfenglu
唐村	tangcun
锦溪	jinxi
一汽大众	yiqidazhong
庄行	zhuanghang
喀什东路	kashidonglu
北道口	beidaokou
溪翁庄	xiwengzhuang
建设南大街	jianshenandajie
八经	bajing
湖南财专	hunancaizhuan
桥中	qiaozhong
鼓山	gushan
张浦	zhangpu
通化路	tonghualu
湖滨北路	hubinbeilu
站前商场	zhanqianshangchang
吴淞	wusong
北洼路	beiwalu
湖滨新村	hubinxincun
五显	wuxian
黄河路	huanghelu
店埠	dianbu
辛安	xinan
清名桥	qingmingqiao
临沂机场	linyijichang
雅荷花园	yahehuayuan
洇溜	yinliu
转塘	zhuantang
西单	xidan
革新	gexin
东塔	dongta
巴黎春天	balichuntian
梅园	meiyuan
新华北路	xinhuabeilu
招商大厦	zhaoshangdasha
天园	tianyuan
临济	linji
横琴	hengqin
平安公园	pingangongyuan
石塘	shitang
天苑	tianyuan
铁心桥	tiexinqiao
运河北路	yunhebeilu
正阳街	zhengyang
立岗	ligang
飞跃广场	feiyueguangchang
虎坊桥	hufangqiao
长春路	changchunlu
大学南路	daxuenanlu
培黎广场	peiliguangchang
东岭街	donglingjie
大邱庄	daqiuzhuang
联想桥	lianxiangqiao
横村	hengcun
海拉尔西路	hailaerxilu
甲子	jiazi
明秀路	mingxiulu
曹张新村	caozhangxincun
九亭	jiuting
肖家河	xiaojiahe
柘塘	zhetang
市中心	shizhongxin
金桥	jinqiao
留下	liuxia
仲夏路	zhongxialu
草市街	caoshijie
江滨路	jiangbinlu
中方园	zhongfangyuan
龙兴	longxing
绿东村	lvdongcun
茨坝	ciba
杨埠寨	yangbuzhai
汤峪	tangyu
黄洲	huangzhou
解放西街	jiefangxijie
迎风	yingfeng
钱江新城	qianjiangxincheng
曲阳路	quyanglu
重庆路	chongqing
德政园	dezhengyuan
小寨路	xiaozhailu
黄忠	huangzhong
铁路东村街	tieludongcunjie
百胜	baisheng
大菜市	dacaishi
成佳	chengjia
南阳新村	nanyangxincun
北海街	beihaijie
岳麓山	yuelushan
洛碛	luoqi
景田	jingtian
后海	houhai
美丽365花园	meili365huayuan
光荣	guangrong
经七路	jingqilu
福兴	fuxing
海事大学	haishidaxue
黄溪	huangxi
司里街	silijie
林山寨	linshanzhai
八大湖	badahu
洪山坡	hongshanpo
洪庆	hongqing
锦城	jincheng
民主	hepingminzhu
新开口	xinkaikou
三孝口	sanxiaokou
精英中学	jingyingzhongxue
崂山区政府	laoshanquzhengfu
曙光中路	shuguangzhonglu
田贝	tianbei
水土	shuitu
安埠	anbu
沧湖北路	canghubeilu
文昌街道	wenchangjiedao
金华	jinhua
珞珈山	luojiashan
大直沽	dazhigu
万岁街	wansuijie
丁字沽	dingzigu
影视城	yingshicheng
下淀	xiadian
武林	wulin
陇海东路	longhaidonglu
唐山街	tangshanjie
陶瓷科技城	taocikejicheng
万埠	wanbu
吴圩	wuxu
芳村	fangcun
上师大	shangshida
周格庄	zhougezhuang
八里庄	balizhuang
莲前东路	lianqiandonglu
沙井	shajing
草堂	caotang
致和	zhihe
国基路	guojilu
南开周边	nankaizhoubian
五里亭	wuliting
三和五街	sanhewujie
玉皇阁北街	yuhuanggebeijie
泡崖	paoya
和平南	hepingnan
达龙	dalong
陈家坝	chenjiaba
省实验	shengshiyan
三一大道	sanyidadao
后湖	houhuxiang
新建镇	xinjianzhen
