short_name	domain	short_name	url
井陉	sjz	石家庄	jingxing
井陉矿区	sjz	石家庄	jingxingkuangqu
元氏	sjz	石家庄	yuanshi
平山	sjz	石家庄	pingshan
开发区	sjz	石家庄	kaifaqu
新乐	sjz	石家庄	xinle
新华	sjz	石家庄	xinhua
无极	sjz	石家庄	wuji
晋州	sjz	石家庄	jinzhou
栾城	sjz	石家庄	luancheng
桥东	sjz	石家庄	qiaodong
桥西	sjz	石家庄	qiaoxi
正定	sjz	石家庄	zhengding
深泽	sjz	石家庄	shenze
灵寿	sjz	石家庄	lingshou
藁城	sjz	石家庄	gaocheng
行唐	sjz	石家庄	xingtang
裕华	sjz	石家庄	yuhua
赞皇	sjz	石家庄	zanhuang
赵县	sjz	石家庄	zhaoxian
辛集	sjz	石家庄	xinji
长安	sjz	石家庄	changan
高邑	sjz	石家庄	gaoyi
鹿泉	sjz	石家庄	luquan
丰南区	tangshan	唐山	fengnan
丰润区	tangshan	唐山	fengrun
乐亭	tangshan	唐山	leting
南堡开发区	tangshan	唐山	nanpukaifa
古冶区	tangshan	唐山	guye
唐海	tangshan	唐山	tanghai
开平区	tangshan	唐山	kaiping
曹妃甸	tangshan	唐山	caofeidian
汉沽农场	tangshan	唐山	hangunongchang
海港开发区	tangshan	唐山	haigangkaifa
滦南	tangshan	唐山	luannan
滦县	tangshan	唐山	luanxian
玉田	tangshan	唐山	yutian
芦台农场	tangshan	唐山	lutainongchang
路北区	tangshan	唐山	lubei
路南区	tangshan	唐山	lunan
迁安	tangshan	唐山	qianan
迁西	tangshan	唐山	qianxi
遵化	tangshan	唐山	zunhua
高新区	tangshan	唐山	gaoxinqu
北戴河区	qinhuangdao	秦皇岛	beidaihe
卢龙	qinhuangdao	秦皇岛	lulong
山海关区	qinhuangdao	秦皇岛	shanhaiguan
抚宁	qinhuangdao	秦皇岛	funing
昌黎	qinhuangdao	秦皇岛	changli
海港区	qinhuangdao	秦皇岛	haigang
青龙	qinhuangdao	秦皇岛	qinglong
丛台区	handan	邯郸	congtai
临漳	handan	邯郸	linzhang
复兴区	handan	邯郸	fuxing
大名	handan	邯郸	daming
峰峰矿区	handan	邯郸	fengfengkuang
广平	handan	邯郸	guangping
成安	handan	邯郸	chengan
曲周	handan	邯郸	quzhou
武安区	handan	邯郸	wuan
永年	handan	邯郸	yongnian
涉县	handan	邯郸	shexian
磁县	handan	邯郸	cixian
肥乡	handan	邯郸	feixiang
邯山区	handan	邯郸	hanshan
邯郸县	handan	邯郸	handanxian
邱县	handan	邯郸	qiuxian
馆陶	handan	邯郸	guantao
魏县	handan	邯郸	weixian
鸡泽	handan	邯郸	jize
临城	xingtai	邢台	lincheng
临西	xingtai	邢台	linxi
任县	xingtai	邢台	renxian
内丘	xingtai	邢台	neiqiu
南和	xingtai	邢台	nanhe
南宫	xingtai	邢台	nangong
威县	xingtai	邢台	weixian
宁晋	xingtai	邢台	ningjin
巨鹿	xingtai	邢台	julu
平乡	xingtai	邢台	pingxiang
广宗	xingtai	邢台	guangzong
新河	xingtai	邢台	xinhe
柏乡	xingtai	邢台	baixiang
桥东区	xingtai	邢台	qiaodong
桥西区	xingtai	邢台	qiaoxi
沙河	xingtai	邢台	shahe
清河	xingtai	邢台	qinghe
邢台县	xingtai	邢台	xingtaixian
隆尧	xingtai	邢台	longyao
北市区	baoding	保定	beishi
南市区	baoding	保定	nanshi
博野	baoding	保定	boye
唐县	baoding	保定	tangxian
安国	baoding	保定	anguo
安新	baoding	保定	anxin
定兴	baoding	保定	dingxing
定州	baoding	保定	dingzhou
容城	baoding	保定	rongcheng
徐水	baoding	保定	xushui
新市区	baoding	保定	xinshi
易县	baoding	保定	yixian
曲阳	baoding	保定	quyang
望都	baoding	保定	wangdou
涞水	baoding	保定	laishui
涞源	baoding	保定	laiyuan
涿州	baoding	保定	zhuozhou
清苑	baoding	保定	qingyuan
满城	baoding	保定	mancheng
蠡县	baoding	保定	lixian
阜平	baoding	保定	fuping
雄县	baoding	保定	xiongxian
顺平	baoding	保定	shunping
高开区	baoding	保定	gaokai
高碑店	baoding	保定	gaobeidian
高阳	baoding	保定	gaoyang
万全	zhangjiakou	张家口	wanquan
下花园区	zhangjiakou	张家口	xiahuayuan
宣化	zhangjiakou	张家口	xuanhua
宣化区	zhangjiakou	张家口	xuanhuaqu
尚义	zhangjiakou	张家口	shangyi
崇礼	zhangjiakou	张家口	chongli
康保	zhangjiakou	张家口	kangbao
张北	zhangjiakou	张家口	zhangbei
怀安	zhangjiakou	张家口	huaian
怀来	zhangjiakou	张家口	huailai
桥东区	zhangjiakou	张家口	qiaodong
桥西区	zhangjiakou	张家口	qiaoxi
沽源	zhangjiakou	张家口	guyuan
涿鹿	zhangjiakou	张家口	zhuolu
蔚县	zhangjiakou	张家口	weixian
赤城	zhangjiakou	张家口	chicheng
阳原	zhangjiakou	张家口	yangyuan
高新区	zhangjiakou	张家口	gaoxin
丰宁	chengde	承德	fengning
兴隆	chengde	承德	xinglong
双桥区	chengde	承德	shuangqiao
双滦区	chengde	承德	shuangluan
围场	chengde	承德	weichang
宽城	chengde	承德	kuancheng
平泉	chengde	承德	pingquan
承德县	chengde	承德	chengdexian
滦平	chengde	承德	luanping
隆化	chengde	承德	longhua
鹰手营子	chengde	承德	yingshouyingzi
东光	cangzhou	沧州	dongguang
任丘	cangzhou	沧州	renqiu
南皮	cangzhou	沧州	nanpi
吴桥	cangzhou	沧州	wuqiao
孟村	cangzhou	沧州	mengcun
新华区	cangzhou	沧州	xinhua
沧县	cangzhou	沧州	cangxian
河间	cangzhou	沧州	hejian
泊头	cangzhou	沧州	botou
海兴	cangzhou	沧州	haixing
献县	cangzhou	沧州	xianxian
盐山	cangzhou	沧州	yanshan
肃宁	cangzhou	沧州	suning
运河区	cangzhou	沧州	yunhe
青县	cangzhou	沧州	qingxian
黄骅	cangzhou	沧州	huanghua
三河	langfang	廊坊	sanhe
固安	langfang	廊坊	guan
大厂	langfang	廊坊	dachang
大城	langfang	廊坊	dacheng
安次区	langfang	廊坊	anci
广阳区	langfang	廊坊	guangyang
开发区	langfang	廊坊	kaifaqu
文安	langfang	廊坊	wenan
永清	langfang	廊坊	yongqing
燕郊	langfang	廊坊	yanjiao
霸州	langfang	廊坊	bazhou
香河	langfang	廊坊	xianghe
冀州	hengshui	衡水	jizhou
安平	hengshui	衡水	anping
开发区	hengshui	衡水	kaifaqu
故城	hengshui	衡水	gucheng
景县	hengshui	衡水	jingxian
枣强	hengshui	衡水	zaoqiang
桃城区	hengshui	衡水	taocheng
武强	hengshui	衡水	wuqiang
武邑	hengshui	衡水	wuyixian
深州	hengshui	衡水	shenzhen
阜城	hengshui	衡水	fucheng
饶阳	hengshui	衡水	raoyang
东城	bj	北京	dongcheng
丰台	bj	北京	fengtai
北京周边	bj	北京	beijingzhoubian
大兴	bj	北京	daxing
宣武	bj	北京	xuanwu
密云	bj	北京	miyun
崇文	bj	北京	chongwen
平谷	bj	北京	pinggu
延庆	bj	北京	yanqing
怀柔	bj	北京	huairou
房山	bj	北京	fangshan
昌平	bj	北京	changping
朝阳	bj	北京	chaoyang
海淀	bj	北京	haidian
燕郊	bj	北京	yanjiao
石景山	bj	北京	shijingshan
西城	bj	北京	xicheng
通州	bj	北京	tongzhou
门头沟	bj	北京	mentougou
顺义	bj	北京	shunyi
上海周边	sh	上海	shanghaizhoubian
南汇	sh	上海	nanhui
卢湾	sh	上海	luwan
嘉定	sh	上海	jiading
奉贤	sh	上海	fengxian
宝山	sh	上海	baoshan
崇明	sh	上海	chongming
徐汇	sh	上海	xuhui
普陀	sh	上海	putuo
杨浦	sh	上海	yangpu
松江	sh	上海	songjiang
浦东	sh	上海	pudongxinqu
虹口	sh	上海	hongkou
金山	sh	上海	jinshan
长宁	sh	上海	changning
闵行	sh	上海	minhang
闸北	sh	上海	zhabei
青浦	sh	上海	qingpu
静安	sh	上海	jingan
黄浦	sh	上海	huangpu
东丽	tj	天津	dongli
北辰	tj	天津	beichen
南开	tj	天津	nankai
和平	tj	天津	heping
塘沽	tj	天津	tanggu
大港	tj	天津	dagang
宁河	tj	天津	ninghe
宝坻	tj	天津	baodi
开发区	tj	天津	kaifaqu
武清	tj	天津	wuqing
汉沽	tj	天津	hangu
河东	tj	天津	hedong
河北	tj	天津	hebei
河西	tj	天津	hexi
津南	tj	天津	jinnan
红桥	tj	天津	hongqiao
蓟县	tj	天津	jixian
西青	tj	天津	xiqing
静海	tj	天津	jinghai
万州	cq	重庆	wanzhou
万盛	cq	重庆	wansheng
两江新区	cq	重庆	liangjiangxinqu
丰都	cq	重庆	fengdu
九龙坡	cq	重庆	jiulongpo
云阳	cq	重庆	yunyang
其他市县	cq	重庆	qitashixian
北碚	cq	重庆	beibei
南岸	cq	重庆	nanan
南川	cq	重庆	nanchuan
双桥	cq	重庆	shuangqiao
合川	cq	重庆	hechuan
垫江	cq	重庆	dianjiang
城口	cq	重庆	chengkou
大渡口	cq	重庆	dadukou
大足	cq	重庆	dazu
奉节	cq	重庆	fengjie
巫山	cq	重庆	wushan
巫溪	cq	重庆	wuxi
巴南	cq	重庆	banan
开县	cq	重庆	kaixian
彭水	cq	重庆	pengshui
忠县	cq	重庆	zhongxian
梁平	cq	重庆	liangping
武隆	cq	重庆	wulong
永川	cq	重庆	yongchuan
江北	cq	重庆	jiangbei
江津	cq	重庆	jiangjin
沙坪坝	cq	重庆	shapingba
涪陵	cq	重庆	fuling
渝中	cq	重庆	yuzhong
渝北	cq	重庆	yubei
潼南	cq	重庆	tongnan
璧山	cq	重庆	bishan
石柱	cq	重庆	shizhu
秀山	cq	重庆	xiushan
綦江	cq	重庆	qijiang
荣昌	cq	重庆	rongchang
酉阳	cq	重庆	youyang
铜梁	cq	重庆	tongliang
长寿	cq	重庆	changshou
黔江	cq	重庆	qianjiang
从化	gz	广州	conghua
南沙	gz	广州	nansha
增城	gz	广州	zengcheng
天河	gz	广州	tianhe
海珠	gz	广州	haizhu
番禺	gz	广州	fanyu
白云	gz	广州	baiyun
经济开发区	gz	广州	jingjikaifa
花都	gz	广州	huadou
荔湾	gz	广州	liwan
萝岗	gz	广州	luogang
越秀	gz	广州	yuexiu
黄埔	gz	广州	huangpu
光明新区	sz	深圳	guangmingxinqu
南山	sz	深圳	nanshan
坪山新区	sz	深圳	pingshanxinqu
大鹏新区	sz	深圳	dapengxinqu
宝安	sz	深圳	baoan
深圳周边	sz	深圳	shenzhenzhoubian
盐田	sz	深圳	yantian
福田	sz	深圳	futian
罗湖	sz	深圳	luohu
龙岗	sz	深圳	longgang
斗门	zhuhai	珠海	doumen
金湾	zhuhai	珠海	jinwan
香洲	zhuhai	珠海	xiangzhou
南澳	shantou	汕头	nanao
潮南	shantou	汕头	chaonan
潮阳	shantou	汕头	chaoyang
澄海	shantou	汕头	chenghai
濠江	shantou	汕头	haojiang
金平	shantou	汕头	jinping
龙湖	shantou	汕头	longhu
三水	foshan	佛山	sanshui
南海	foshan	佛山	nanhai
禅城	foshan	佛山	chancheng
顺德	foshan	佛山	shunde
高明	foshan	佛山	gaoming
台山	jiangmen	江门	taishan
开平	jiangmen	江门	kaiping
恩平	jiangmen	江门	enping
新会	jiangmen	江门	xinhui
江海	jiangmen	江门	jianghai
蓬江	jiangmen	江门	pengjiang
鹤山	jiangmen	江门	heshan
信宜	maoming	茂名	xinyi
化州	maoming	茂名	huazhou
电白	maoming	茂名	dianbai
茂南	maoming	茂名	maonan
茂港	maoming	茂名	maogang
高州	maoming	茂名	gaozhou
仲恺区	huizhou	惠州	zhongkaiqu
博罗	huizhou	惠州	boluo
大亚湾区	huizhou	惠州	dayawanqu
惠东	huizhou	惠州	huidong
惠城	huizhou	惠州	huicheng
惠阳	huizhou	惠州	huiyang
龙门	huizhou	惠州	longmen
万江	dg	东莞	wanjiang
东坑	dg	东莞	dongkeng
东城	dg	东莞	dongcheng
中堂	dg	东莞	zhongtang
企石	dg	东莞	qishi
凤岗	dg	东莞	fenggang
南城	dg	东莞	nancheng
厚街	dg	东莞	houjie
塘厦	dg	东莞	tangsha
大岭山	dg	东莞	dalingshan
大朗	dg	东莞	dalang
寮步	dg	东莞	liaobu
常平	dg	东莞	changping
望牛墩	dg	东莞	wangniudun
松山湖	dg	东莞	songshanhu
桥头	dg	东莞	qiaotou
樟木头	dg	东莞	zhangmutou
横沥	dg	东莞	hengli
沙田	dg	东莞	shatian
洪梅	dg	东莞	hongmei
清溪	dg	东莞	qingxi
石排	dg	东莞	shipai
石碣	dg	东莞	shijie
石龙	dg	东莞	shilong
茶山	dg	东莞	chashan
莞城	dg	东莞	guancheng
虎门	dg	东莞	humen
谢岗	dg	东莞	xiegang
道	dg	东莞	daorong
长安	dg	东莞	changan
高	dg	东莞	gaobu
麻涌	dg	东莞	mayong
黄江	dg	东莞	huangjiang
三乡	zhongshan	中山	sanxiang
三角	zhongshan	中山	sanjiao
东凤	zhongshan	中山	dongfeng
东区	zhongshan	中山	dongqu
东升	zhongshan	中山	dongsheng
五桂山	zhongshan	中山	wuguishan
南区	zhongshan	中山	nanqu
南头	zhongshan	中山	nantou
南朗	zhongshan	中山	nanlang
古镇	zhongshan	中山	guzhen
坦洲	zhongshan	中山	tanzhou
大涌	zhongshan	中山	dayong
小榄	zhongshan	中山	xiaolan
板芙	zhongshan	中山	banfu
横栏	zhongshan	中山	henglan
民众	zhongshan	中山	minzhong
沙溪	zhongshan	中山	shaxi
港口	zhongshan	中山	gangkou
火炬	zhongshan	中山	huoju
石岐	zhongshan	中山	shiqi
神湾	zhongshan	中山	shenwan
西区	zhongshan	中山	xiqu
阜沙	zhongshan	中山	fusha
黄圃	zhongshan	中山	huangpu
上城	hz	杭州	shangcheng
下城	hz	杭州	xiacheng
临安	hz	杭州	linan
余杭	hz	杭州	yuhang
富阳	hz	杭州	fuyang
建德	hz	杭州	jiande
拱墅	hz	杭州	gongshu
桐庐	hz	杭州	tonglu
江干	hz	杭州	jianggan
淳安	hz	杭州	chunan
滨江	hz	杭州	binjiang
萧山	hz	杭州	xiaoshan
西湖	hz	杭州	xihu
余姚	nb	宁波	yuyao
北仑	nb	宁波	beilun
奉化	nb	宁波	fenghua
宁海	nb	宁波	ninghai
慈溪	nb	宁波	cixi
江东	nb	宁波	jiangdong
江北	nb	宁波	jiangbei
海曙	nb	宁波	haishu
甬江	nb	宁波	yongjiang
象山	nb	宁波	xiangshan
鄞州	nb	宁波	yinzhou
镇海	nb	宁波	zhenhai
乐清	wenzhou	温州	leqing
平阳	wenzhou	温州	pingyang
文成	wenzhou	温州	wencheng
永嘉	wenzhou	温州	yongjia
泰顺	wenzhou	温州	taishun
洞头	wenzhou	温州	dongtou
瑞安	wenzhou	温州	ruian
瓯海	wenzhou	温州	ouhai
苍南	wenzhou	温州	cangnan
鹿城	wenzhou	温州	lucheng
龙湾	wenzhou	温州	longwan
南湖	jiaxing	嘉兴	nanhu
嘉善	jiaxing	嘉兴	jiashan
平湖	jiaxing	嘉兴	pinghu
桐乡	jiaxing	嘉兴	tongxiang
海宁	jiaxing	嘉兴	haining
海盐	jiaxing	嘉兴	haiyan
秀洲	jiaxing	嘉兴	xiuzhou
经济开发区	jiaxing	嘉兴	jingjikaifaqu
南浔	huzhou	湖州	nanxun
吴兴	huzhou	湖州	wuxing
安吉	huzhou	湖州	anji
德清	huzhou	湖州	deqing
长兴	huzhou	湖州	changxing
上虞	shaoxing	绍兴	shangyu
嵊州	shaoxing	绍兴	shengzhou
新昌	shaoxing	绍兴	xinchang
绍兴县	shaoxing	绍兴	shaoxing
诸暨	shaoxing	绍兴	zhuji
越城	shaoxing	绍兴	yuecheng
东阳	jinhua	金华	dongyang
义乌	jinhua	金华	yiwu
兰溪	jinhua	金华	lanxi
婺城	jinhua	金华	wucheng
武义	jinhua	金华	wuyi
永康	jinhua	金华	yongkang
浦江	jinhua	金华	pujiang
磐安	jinhua	金华	panan
金东	jinhua	金华	jindong
常山	quzhou	衢州	changshan
开化	quzhou	衢州	kaihua
柯城	quzhou	衢州	kecheng
江山	quzhou	衢州	jiangshan
衢江	quzhou	衢州	qujiang
龙游	quzhou	衢州	longyou
定海	zhoushan	舟山	dinghai
岱山	zhoushan	舟山	daishan
嵊泗	zhoushan	舟山	shengsi
普陀	zhoushan	舟山	putuo
三门	zjtaizhou	台州	sanmen
临海	zjtaizhou	台州	linhai
仙居	zjtaizhou	台州	xianju
天台	zjtaizhou	台州	tiantai
椒江	zjtaizhou	台州	jiaojiang
温岭	zjtaizhou	台州	wenling
玉环	zjtaizhou	台州	yuhuan
路桥	zjtaizhou	台州	luqiao
黄岩	zjtaizhou	台州	huangyan
乌当	gy	贵阳	wudang
云岩	gy	贵阳	yunyan
修文	gy	贵阳	xiuwen
南明	gy	贵阳	nanming
小河	gy	贵阳	xiaohe
小河片	gy	贵阳	xiaohepian
开阳	gy	贵阳	kaiyang
息烽	gy	贵阳	xifeng
清镇	gy	贵阳	qingzhen
白云	gy	贵阳	baiyun
花溪	gy	贵阳	huaxi
金阳新区	gy	贵阳	jinyangxin
六枝特区	liupanshui	六盘水	liuzhite
水城	liupanshui	六盘水	shuicheng
盘县	liupanshui	六盘水	panxian
钟山	liupanshui	六盘水	zhongshan
习水	zunyi	遵义	xishui
仁怀	zunyi	遵义	renhuai
余庆	zunyi	遵义	yuqing
凤冈	zunyi	遵义	fenggang
务川	zunyi	遵义	wuchuan
桐梓	zunyi	遵义	tongzi
正安	zunyi	遵义	zhengan
汇川	zunyi	遵义	huichuan
湄潭	zunyi	遵义	meitan
红花岗	zunyi	遵义	honghuagang
绥阳	zunyi	遵义	suiyang
赤水	zunyi	遵义	chishui
道真	zunyi	遵义	daozhen
遵义县	zunyi	遵义	zunyixian
关岭	anshun	安顺	guanling
平坝	anshun	安顺	pingba
普定	anshun	安顺	puding
紫云	anshun	安顺	ziyun
西秀	anshun	安顺	xixiu
镇宁	anshun	安顺	zhenning
万山	tongren	铜仁	wanshan
印江	tongren	铜仁	yinjiang
德江	tongren	铜仁	dejiang
思南	tongren	铜仁	sinan
松桃	tongren	铜仁	songtao
江口	tongren	铜仁	jiangkou
沿河	tongren	铜仁	yanhe
玉屏	tongren	铜仁	yuping
石阡	tongren	铜仁	shiqian
铜仁市	tongren	铜仁	tongren
大方	bijie	毕节	dafang
威宁	bijie	毕节	weining
毕节市	bijie	毕节	bijie
纳雍	bijie	毕节	nayong
织金	bijie	毕节	zhijin
赫章	bijie	毕节	hezhang
金沙	bijie	毕节	jinsha
黔西	bijie	毕节	qianxi
兴义	qianxinan	黔西南	xingyi
兴仁	qianxinan	黔西南	xingren
册亨	qianxinan	黔西南	ceheng
安龙	qianxinan	黔西南	anlong
普安	qianxinan	黔西南	puan
晴隆	qianxinan	黔西南	qinglong
望谟	qianxinan	黔西南	wangmo
贞丰	qianxinan	黔西南	zhenfeng
三穗	qiandongnan	黔东南	sansui
丹寨	qiandongnan	黔东南	danzhai
从江	qiandongnan	黔东南	congjiang
凯里	qiandongnan	黔东南	kaili
剑河	qiandongnan	黔东南	jianhe
台江	qiandongnan	黔东南	taijiang
天柱	qiandongnan	黔东南	tianzhu
岑巩	qiandongnan	黔东南	cengong
施秉	qiandongnan	黔东南	shibing
榕江	qiandongnan	黔东南	rongjiang
锦屏	qiandongnan	黔东南	jinping
镇远	qiandongnan	黔东南	zhenyuan
雷山	qiandongnan	黔东南	leishan
麻江	qiandongnan	黔东南	majiang
黄平	qiandongnan	黔东南	huangping
黎平	qiandongnan	黔东南	liping
三都	qiannan	黔南	sandou
平塘	qiannan	黔南	pingtang
惠水	qiannan	黔南	huishui
独山	qiannan	黔南	dushan
瓮安	qiannan	黔南	wengan
福泉	qiannan	黔南	fuquan
罗甸	qiannan	黔南	luodian
荔波	qiannan	黔南	libo
贵定	qiannan	黔南	guiding
都匀	qiannan	黔南	douyun
长顺	qiannan	黔南	changshun
龙里	qiannan	黔南	longli
其他	cd	成都	qita
双流	cd	成都	shuangliu
高新	cd	成都	gaoxin
大邑	cd	成都	dayi
崇州	cd	成都	chongzhou
彭州	cd	成都	pengzhou
成华	cd	成都	chenghua
新津	cd	成都	xinjin
新都	cd	成都	xindu
武侯	cd	成都	wuhou
温江	cd	成都	wenjiang
蒲江	cd	成都	pujiang
邛崃	cd	成都	qionglai
郫县	cd	成都	pixian
都江堰	cd	成都	dujiangyan
金堂	cd	成都	jintang
金牛	cd	成都	jinniu
锦江	cd	成都	jinjiang
青白江	cd	成都	qingbaijiang
青羊	cd	成都	qingyang
高新西区	cd	成都	gaoxinxiqu
龙泉驿	cd	成都	longquanyi
大安	zigong	自贡	daan
富顺	zigong	自贡	fushun
沿滩	zigong	自贡	yantan
自流井	zigong	自贡	ziliujing
荣县	zigong	自贡	rongxian
贡井	zigong	自贡	gongjing
叙永	luzhou	泸州	xuyong
古蔺	luzhou	泸州	gulin
合江	luzhou	泸州	hejiang
江阳	luzhou	泸州	jiangyang
泸县	luzhou	泸州	luxian
纳溪	luzhou	泸州	naxi
龙马潭	luzhou	泸州	longmatan
中江	deyang	德阳	zhongjiang
什邡	deyang	德阳	shenfang
广汉	deyang	德阳	guanghan
旌阳	deyang	德阳	jingyang
绵竹	deyang	德阳	mianzhu
罗江	deyang	德阳	luojiang
三台	mianyang	绵阳	santai
北川	mianyang	绵阳	beichuan
安县	mianyang	绵阳	anxian
平武	mianyang	绵阳	pingwu
梓潼	mianyang	绵阳	zitong
江油	mianyang	绵阳	jiangyou
涪城	mianyang	绵阳	fucheng
游仙	mianyang	绵阳	youxian
盐亭	mianyang	绵阳	yanting
科创园	mianyang	绵阳	kechuangyuan
经开	mianyang	绵阳	jingkai
高新	mianyang	绵阳	gaoxin
五通桥	leshan	乐山	wutongqiao
井研	leshan	乐山	jingyan
夹江	leshan	乐山	jiajiang
峨眉山	leshan	乐山	emeishan
峨边	leshan	乐山	ebian
市中	leshan	乐山	shizhong
沐川	leshan	乐山	muchuan
沙湾	leshan	乐山	shawan
犍为	leshan	乐山	jianwei
金口河	leshan	乐山	jinkouhe
马边	leshan	乐山	mabian
仪陇	nanchong	南充	yilong
南部	nanchong	南充	nanbu
嘉陵	nanchong	南充	jialing
营山	nanchong	南充	yingshan
蓬安	nanchong	南充	pengan
西充	nanchong	南充	xichong
阆中	nanchong	南充	langzhong
顺庆	nanchong	南充	shunqing
高坪	nanchong	南充	gaoping
兴文	yibin	宜宾	xingwen
南溪	yibin	宜宾	nanxi
宜宾县	yibin	宜宾	yibin
屏山	yibin	宜宾	pingshan
江安	yibin	宜宾	jiangan
珙县	yibin	宜宾	gongxian
筠连	yibin	宜宾	junlian
翠屏	yibin	宜宾	cuiping
长宁	yibin	宜宾	zhangning
高县	yibin	宜宾	gaoxian
万源	dazhou	达州	wanyuan
大竹	dazhou	达州	dazhu
宣汉	dazhou	达州	xuanhan
开江	dazhou	达州	kaijiang
渠县	dazhou	达州	quxian
达县	dazhou	达州	daxian
通川	dazhou	达州	tongchuan
会东	liangshan	凉山	huidong
会理	liangshan	凉山	huili
冕宁	liangshan	凉山	mianning
喜德	liangshan	凉山	xide
宁南	liangshan	凉山	ningnan
布拖	liangshan	凉山	butuo
德昌	liangshan	凉山	dechang
昭觉	liangshan	凉山	zhaojue
普格	liangshan	凉山	puge
木里	liangshan	凉山	muli
甘洛	liangshan	凉山	ganluo
盐源	liangshan	凉山	yanyuan
美姑	liangshan	凉山	meigu
西昌	liangshan	凉山	xichang
越西	liangshan	凉山	yuexi
金阳	liangshan	凉山	jinyang
雷波	liangshan	凉山	leibo
东陵	sy	沈阳	dongling
于洪	sy	沈阳	yuhong
和平	sy	沈阳	heping
大东	sy	沈阳	dadong
康平	sy	沈阳	kangping
新民	sy	沈阳	xinmin
沈北	sy	沈阳	shenbei
沈河	sy	沈阳	shenhe
法库	sy	沈阳	faku
浑南	sy	沈阳	hunnan
皇姑	sy	沈阳	huanggu
苏家屯	sy	沈阳	sujiatun
辽中	sy	沈阳	liaozhong
铁西	sy	沈阳	tiexi
中山	dl	大连	zhongshan
庄河	dl	大连	zhuanghe
开发区	dl	大连	kaifa
旅顺口	dl	大连	lvshunkou
普兰店	dl	大连	pulandian
沙河口	dl	大连	shahekou
瓦房店	dl	大连	wafangdian
甘井子	dl	大连	ganjingzi
西岗	dl	大连	xigang
金州	dl	大连	jinzhou
长海	dl	大连	changhai
高新园区	dl	大连	gaoxinyuanqu
千山	anshan	鞍山	qianshan
台安	anshan	鞍山	taian
岫岩	anshan	鞍山	xiuyan
海城	anshan	鞍山	haicheng
立山	anshan	鞍山	lishan
铁东	anshan	鞍山	tiedong
铁西	anshan	鞍山	tiexi
东洲	fushun	抚顺	dongzhou
抚顺县	fushun	抚顺	fushun
新宾	fushun	抚顺	xinbin
新抚	fushun	抚顺	xinfu
望花	fushun	抚顺	wanghua
清原	fushun	抚顺	qingyuan
顺城	fushun	抚顺	shuncheng
东港	dandong	丹东	donggang
元宝	dandong	丹东	yuanbao
凤城	dandong	丹东	fengcheng
宽甸	dandong	丹东	kuandian
振兴	dandong	丹东	zhenxing
振安	dandong	丹东	zhenan
义县	jinzhou	锦州	yixian
凌河	jinzhou	锦州	linghe
凌海	jinzhou	锦州	linghai
北宁	jinzhou	锦州	beining
古塔	jinzhou	锦州	guta
太和	jinzhou	锦州	taihe
黑山	jinzhou	锦州	heishan
大石桥	yingkou	营口	dashiqiao
盖州	yingkou	营口	gaizhou
站前	yingkou	营口	zhanqian
老边	yingkou	营口	laobian
西市	yingkou	营口	xishi
鲅鱼圈	yingkou	营口	bayuquan
太子河	liaoyang	辽阳	taizihe
宏伟	liaoyang	辽阳	hongwei
弓长岭	liaoyang	辽阳	gongzhangling
文圣	liaoyang	辽阳	wensheng
灯塔	liaoyang	辽阳	dengta
白塔	liaoyang	辽阳	baita
辽阳县	liaoyang	辽阳	liaoyang
兴隆台	panjin	盘锦	xinglongtai
双台子	panjin	盘锦	shuangtaizi
大洼	panjin	盘锦	dawa
盘山	panjin	盘锦	panshan
兴城	huludao	葫芦岛	xingcheng
南票	huludao	葫芦岛	nanpiao
建昌	huludao	葫芦岛	jianchang
绥中	huludao	葫芦岛	suizhong
连山	huludao	葫芦岛	lianshan
龙港	huludao	葫芦岛	longgang
下关	nj	南京	xiaguan
六合	nj	南京	liuhe
南京周边	nj	南京	nanjingzhoubian
大厂	nj	南京	dachang
建邺	nj	南京	jianye
栖霞	nj	南京	qixia
江宁	nj	南京	jiangning
浦口	nj	南京	pukou
溧水	nj	南京	lishui
玄武	nj	南京	xuanwu
白下	nj	南京	baixia
秦淮	nj	南京	qinhuai
雨花台	nj	南京	yuhuatai
高淳	nj	南京	gaochun
鼓楼	nj	南京	gulou
北塘	wx	无锡	beitang
南长	wx	无锡	nanchang
宜兴	wx	无锡	yixing
崇安	wx	无锡	chongan
惠山	wx	无锡	huishan
新区	wx	无锡	xinqu
江阴	wx	无锡	jiangyin
滨湖	wx	无锡	binhu
锡山	wx	无锡	xishan
吴中	su	苏州	wuzhong
吴江	su	苏州	wujiang
园区	su	苏州	yuanqu
太仓	su	苏州	taicang
常熟	su	苏州	changshu
平江	su	苏州	pingjiang
张家港	su	苏州	zhangjiagang
新区	su	苏州	xinqu
昆山	su	苏州	kunshan
沧浪	su	苏州	canglang
相城	su	苏州	xiangcheng
金阊	su	苏州	jinchang
丰县	xuzhou	徐州	fengxian
九里	xuzhou	徐州	jiuli
云龙	xuzhou	徐州	yunlong
新城区	xuzhou	徐州	xinchengqu
新沂	xuzhou	徐州	xinyi
沛县	xuzhou	徐州	peixian
泉山	xuzhou	徐州	quanshan
睢宁	xuzhou	徐州	suining
贾汪	xuzhou	徐州	jiawang
邳州	xuzhou	徐州	pizhou
金山桥开发区	xuzhou	徐州	jinshanqiaokaifaqu
铜山	xuzhou	徐州	tongshan
鼓楼	xuzhou	徐州	gulou
天宁	changzhou	常州	tianning
戚墅堰	changzhou	常州	qishuyan
新北	changzhou	常州	xinbei
武进	changzhou	常州	wujin
溧阳	changzhou	常州	liyang
金坛	changzhou	常州	jintan
钟楼	changzhou	常州	zhonglou
启东	nantong	南通	qidong
如东	nantong	南通	rudong
如皋	nantong	南通	rugao
崇川	nantong	南通	chongchuan
开发区	nantong	南通	kaifaqu
海安	nantong	南通	haian
海门	nantong	南通	haimen
港闸	nantong	南通	gangzha
通州	nantong	南通	tongzhou
东海	lianyungang	连云港	donghai
新浦	lianyungang	连云港	xinpu
海州	lianyungang	连云港	haizhou
灌云	lianyungang	连云港	guanyun
灌南	lianyungang	连云港	guannan
赣榆	lianyungang	连云港	ganyu
连云	lianyungang	连云港	lianyun
楚州	huaian	淮安	chuzhou
洪泽	huaian	淮安	hongze
涟水	huaian	淮安	lianshui
淮阴	huaian	淮安	huaiyin
清河	huaian	淮安	qinghe
清浦	huaian	淮安	qingpu
盱眙	huaian	淮安	xuyi
金湖	huaian	淮安	jinhu
东台	yancheng	盐城	dongtai
亭湖	yancheng	盐城	tinghu
响水	yancheng	盐城	xiangshui
大丰	yancheng	盐城	dafeng
射阳	yancheng	盐城	sheyang
建湖	yancheng	盐城	jianhu
滨海	yancheng	盐城	binhai
盐都	yancheng	盐城	yandou
阜宁	yancheng	盐城	funing
仪征	yangzhou	扬州	yizheng
宝应	yangzhou	扬州	baoying
广陵	yangzhou	扬州	guangling
开发区	yangzhou	扬州	hanjiangqu
江都	yangzhou	扬州	jiangdou
维扬	yangzhou	扬州	weiyang
邗江	yangzhou	扬州	hanjiang
高邮	yangzhou	扬州	gaoyou
仓山	fz	福州	cangshan
其他	fz	福州	qita
台江	fz	福州	taijiang
平潭	fz	福州	pingtan
晋安	fz	福州	jinan
永泰	fz	福州	yongtai
福清	fz	福州	fuqing
罗源	fz	福州	luoyuan
连江	fz	福州	lianjiang
长乐	fz	福州	changle
闽侯	fz	福州	minhou
闽清	fz	福州	minqing
马尾	fz	福州	mawei
鼓楼	fz	福州	gulou
同安	xm	厦门	tongan
思明	xm	厦门	siming
海沧	xm	厦门	haicang
湖里	xm	厦门	huli
翔安	xm	厦门	xiangan
集美	xm	厦门	jimei
仙游	putian	莆田	xianyou
城厢	putian	莆田	chengxiang
涵江	putian	莆田	hanjiang
秀屿	putian	莆田	xiuyu
荔城	putian	莆田	licheng
三元	sanming	三明	sanyuan
大田	sanming	三明	datian
宁化	sanming	三明	ninghua
将乐	sanming	三明	jiangle
尤溪	sanming	三明	youxi
建宁	sanming	三明	jianning
明溪	sanming	三明	mingxi
梅列	sanming	三明	meilie
永安	sanming	三明	yongan
沙县	sanming	三明	shaxian
泰宁	sanming	三明	taining
清流	sanming	三明	qingliu
丰泽	quanzhou	泉州	fengze
南安	quanzhou	泉州	nanan
安溪	quanzhou	泉州	anxi
德化	quanzhou	泉州	dehua
惠安	quanzhou	泉州	huian
晋江	quanzhou	泉州	jinjiang
永春	quanzhou	泉州	yongchun
泉港	quanzhou	泉州	quangang
洛江	quanzhou	泉州	luojiang
石狮	quanzhou	泉州	shishi
金门	quanzhou	泉州	jinmen
鲤城	quanzhou	泉州	licheng
东山	zhangzhou	漳州	dongshan
云霄	zhangzhou	漳州	yunxiao
华安	zhangzhou	漳州	huaan
南靖	zhangzhou	漳州	nanjing
平和	zhangzhou	漳州	pinghe
漳浦	zhangzhou	漳州	zhangpu
芗城	zhangzhou	漳州	xiangcheng
诏安	zhangzhou	漳州	zhaoan
长泰	zhangzhou	漳州	changtai
龙文	zhangzhou	漳州	longwen
龙海	zhangzhou	漳州	longhai
光泽	nanping	南平	guangze
延平	nanping	南平	yanping
建瓯	nanping	南平	jianou
建阳	nanping	南平	jianyang
政和	nanping	南平	zhenghe
松溪	nanping	南平	songxi
武夷山	nanping	南平	wuyishan
浦城	nanping	南平	pucheng
邵武	nanping	南平	shaowu
顺昌	nanping	南平	shunchang
上杭	longyan	龙岩	shanghang
新罗	longyan	龙岩	xinluo
武平	longyan	龙岩	wuping
永定	longyan	龙岩	yongding
漳平	longyan	龙岩	zhangping
连城	longyan	龙岩	liancheng
长汀	longyan	龙岩	changting
古田	ningde	宁德	gutian
周宁	ningde	宁德	zhouning
寿宁	ningde	宁德	shouning
屏南	ningde	宁德	pingnan
柘荣	ningde	宁德	zherong
福安	ningde	宁德	fuan
福鼎	ningde	宁德	fuding
蕉城	ningde	宁德	jiaocheng
霞浦	ningde	宁德	xiapu
九台	cc	长春	jiutai
二道	cc	长春	erdao
其他	cc	长春	qita
农安	cc	长春	nongan
净月	cc	长春	jingyue
南关	cc	长春	nanguan
双阳	cc	长春	shuangyang
宽城	cc	长春	kuancheng
德惠	cc	长春	dehui
朝阳	cc	长春	chaoyang
榆树	cc	长春	yushu
汽车城	cc	长春	qichecheng
经开	cc	长春	jingkai
绿园	cc	长春	lvyuan
高新	cc	长春	gaoxin
丰满区	jilin	吉林	fengmanqu
昌邑区	jilin	吉林	changyiqu
桦甸	jilin	吉林	huadian
永吉	jilin	吉林	yongji
磐石	jilin	吉林	panshi
经开区	jilin	吉林	jingkaiqu
舒兰	jilin	吉林	shulan
船营区	jilin	吉林	chuanyingqu
蛟河	jilin	吉林	jiaohe
高新区	jilin	吉林	gaoxinqu
龙潭区	jilin	吉林	longtanqu
伊通	siping	四平	yitong
公主岭	siping	四平	gongzhuling
双辽	siping	四平	shuangliao
梨树	siping	四平	lishu
铁东区	siping	四平	tiedongqu
铁西区	siping	四平	tiexiqu
东丰	liaoyuan	辽源	dongfeng
东辽	liaoyuan	辽源	dongliao
西安区	liaoyuan	辽源	xianqu
龙山区	liaoyuan	辽源	longshanqu
东昌区	tonghua	通化	dongchangqu
二道江区	tonghua	通化	erdaojiangqu
柳河	tonghua	通化	liuhe
梅河口	tonghua	通化	meihekou
辉南	tonghua	通化	huinan
通化县	tonghua	通化	tonghuaxian
集安	tonghua	通化	jian
临江市	baishan	白山	linjiangshi
八道江区	baishan	白山	badaojiangqu
抚松县	baishan	白山	fusongxian
江源区	baishan	白山	jiangyuanqu
长白	baishan	白山	zhangbai
靖宇县	baishan	白山	jingyuxian
乾安	songyuan	松原	qianan
前郭尔罗斯	songyuan	松原	qianguoerluosi
宁江区	songyuan	松原	ningjiangqu
扶余	songyuan	松原	fuyu
长岭	songyuan	松原	changling
大安	baicheng	白城	daan
洮北区	baicheng	白城	taobeiqu
洮南	baicheng	白城	taonan
通榆	baicheng	白城	tongyu
镇赉	baicheng	白城	zhenlai
和龙	yanbian	延边	helong
图们	yanbian	延边	tumen
安图	yanbian	延边	antu
延吉	yanbian	延边	yanji
敦化	yanbian	延边	dunhua
汪清	yanbian	延边	wangqing
珲春	yanbian	延边	huichun
龙井	yanbian	延边	longjing
五常	hrb	哈尔滨	wuchang
依兰	hrb	哈尔滨	yilan
南岗	hrb	哈尔滨	nangang
双城	hrb	哈尔滨	shuangcheng
宾县	hrb	哈尔滨	binxian
尚志	hrb	哈尔滨	shangzhi
巴彦	hrb	哈尔滨	bayan
平房	hrb	哈尔滨	pingfang
延寿	hrb	哈尔滨	yanshou
开发区	hrb	哈尔滨	kaifaqu
方正	hrb	哈尔滨	fangzheng
木兰	hrb	哈尔滨	mulan
江北	hrb	哈尔滨	songbei
通河	hrb	哈尔滨	tonghe
道外	hrb	哈尔滨	daowai
道里	hrb	哈尔滨	daoli
阿城	hrb	哈尔滨	acheng
香坊	hrb	哈尔滨	xiangfang
依安	qiqihaer	齐齐哈尔	yian
克东	qiqihaer	齐齐哈尔	kedong
克山	qiqihaer	齐齐哈尔	keshan
富拉尔基	qiqihaer	齐齐哈尔	fulaerji
富裕	qiqihaer	齐齐哈尔	fuyu
建华	qiqihaer	齐齐哈尔	jianhua
拜泉	qiqihaer	齐齐哈尔	baiquan
昂昂溪	qiqihaer	齐齐哈尔	angangxi
梅里斯	qiqihaer	齐齐哈尔	meilisi
泰来	qiqihaer	齐齐哈尔	tailai
甘南	qiqihaer	齐齐哈尔	gannan
碾子山	qiqihaer	齐齐哈尔	nianzishan
讷河	qiqihaer	齐齐哈尔	nehe
铁锋	qiqihaer	齐齐哈尔	tiefeng
龙江	qiqihaer	齐齐哈尔	longjiang
龙沙	qiqihaer	齐齐哈尔	longsha
城子河	jixi	鸡西	chengzihe
密山	jixi	鸡西	mishan
恒山	jixi	鸡西	hengshan
梨树	jixi	鸡西	lishu
滴道	jixi	鸡西	didao
虎林	jixi	鸡西	hulin
鸡东	jixi	鸡西	jidong
鸡冠	jixi	鸡西	jiguan
麻山	jixi	鸡西	mashan
东山	hegang	鹤岗	dongshan
兴安	hegang	鹤岗	xingan
兴山	hegang	鹤岗	xingshan
南山	hegang	鹤岗	nanshan
向阳	hegang	鹤岗	xiangyang
工农	hegang	鹤岗	gongnong
绥滨	hegang	鹤岗	suibin
萝北	hegang	鹤岗	luobei
友谊	shuangyashan	双鸭山	youyi
四方台	shuangyashan	双鸭山	sifangtai
宝山	shuangyashan	双鸭山	baoshan
宝清	shuangyashan	双鸭山	baoqing
尖山	shuangyashan	双鸭山	jianshan
岭东	shuangyashan	双鸭山	lingdong
集贤	shuangyashan	双鸭山	jixian
饶河	shuangyashan	双鸭山	raohe
大同	daqing	大庆	datong
杜尔伯特	daqing	大庆	duerbote
林甸	daqing	大庆	lindian
红岗	daqing	大庆	honggang
肇州	daqing	大庆	zhaozhou
肇源	daqing	大庆	zhaoyuan
萨尔图	daqing	大庆	saertu
让胡路	daqing	大庆	ranghulu
龙凤	daqing	大庆	longfeng
上甘岭	hljyichun	伊春	shangganling
乌伊岭	hljyichun	伊春	wuyiling
乌马河	hljyichun	伊春	wumahe
五营	hljyichun	伊春	wuying
伊春区	hljyichun	伊春	yichun
南岔	hljyichun	伊春	nancha
友好	hljyichun	伊春	youhao
嘉荫	hljyichun	伊春	jiayin
带岭	hljyichun	伊春	dailing
新青	hljyichun	伊春	xinqing
汤旺河	hljyichun	伊春	tangwanghe
红星	hljyichun	伊春	hongxing
美溪	hljyichun	伊春	meixi
翠峦	hljyichun	伊春	cuiluan
西林	hljyichun	伊春	xilin
金山屯	hljyichun	伊春	jinshantun
铁力	hljyichun	伊春	tieli
东风	jiamusi	佳木斯	dongfeng
前进	jiamusi	佳木斯	qianjin
同江	jiamusi	佳木斯	tongjiang
向阳	jiamusi	佳木斯	xiangyang
富锦	jiamusi	佳木斯	fujin
抚远	jiamusi	佳木斯	fuyuan
桦南	jiamusi	佳木斯	huanan
桦川	jiamusi	佳木斯	huachuan
汤原	jiamusi	佳木斯	tangyuan
郊区	jiamusi	佳木斯	jiaoqu
五大连池	heihe	黑河	wudalianchi
北安	heihe	黑河	beian
嫩江	heihe	黑河	nenjiang
孙吴	heihe	黑河	sunwu
爱辉	heihe	黑河	aihui
逊克	heihe	黑河	xunke
兰西	suihua	绥化	lanxi
北林	suihua	绥化	beilin
安达	suihua	绥化	anda
庆安	suihua	绥化	qingan
明水	suihua	绥化	mingshui
望奎	suihua	绥化	wangkui
海伦	suihua	绥化	hailun
绥棱	suihua	绥化	suileng
肇东	suihua	绥化	zhaodong
青冈	suihua	绥化	qinggang
上街	zz	郑州	shangjie
中原	zz	郑州	zhongyuan
中牟	zz	郑州	zhongmou
二七	zz	郑州	erqi
巩义	zz	郑州	gongyi
惠济	zz	郑州	huiji
新密	zz	郑州	xinmi
新郑	zz	郑州	xinzheng
登封	zz	郑州	dengfeng
管城	zz	郑州	guanchenghuizu
经开区	zz	郑州	jingkaiqu
荥阳	zz	郑州	xingyang
郑东	zz	郑州	zhengdong
金水	zz	郑州	jinshui
高新区	zz	郑州	gaoxinqu
伊川	luoyang	洛阳	yichuan
偃师	luoyang	洛阳	yanshi
吉利	luoyang	洛阳	jili
孟津	luoyang	洛阳	mengjin
宜阳	luoyang	洛阳	yiyang
嵩县	luoyang	洛阳	songxian
新安	luoyang	洛阳	xinan
栾川	luoyang	洛阳	luanchuan
汝阳	luoyang	洛阳	ruyang
洛宁	luoyang	洛阳	luoning
洛龙	luoyang	洛阳	luolong
涧西	luoyang	洛阳	jianxi
e河	luoyang	洛阳	chanhe
老城	luoyang	洛阳	laocheng
西工	luoyang	洛阳	xigong
卫东	pingdingshan	平顶山	weidong
叶县	pingdingshan	平顶山	yexian
宝丰	pingdingshan	平顶山	baofeng
新华	pingdingshan	平顶山	xinhua
汝州	pingdingshan	平顶山	ruzhou
湛河	pingdingshan	平顶山	zhanhe
石龙	pingdingshan	平顶山	shilong
舞钢	pingdingshan	平顶山	wugang
郏县	pingdingshan	平顶山	jiaxian
鲁山	pingdingshan	平顶山	lushan
中站	jiaozuo	焦作	zhongzhan
修武	jiaozuo	焦作	xiuwu
博爱	jiaozuo	焦作	boai
孟州	jiaozuo	焦作	mengzhou
山阳	jiaozuo	焦作	shanyang
武陟	jiaozuo	焦作	wuzhi
沁阳	jiaozuo	焦作	qinyang
温县	jiaozuo	焦作	wenxian
解放	jiaozuo	焦作	jiefang
马村	jiaozuo	焦作	macun
高新	jiaozuo	焦作	gaoxin
山城	hebi	鹤壁	shancheng
浚县	hebi	鹤壁	junxian
淇县	hebi	鹤壁	qixian
淇滨	hebi	鹤壁	qibin
鹤山	hebi	鹤壁	heshan
凤泉	xinxiang	新乡	fengquan
卫滨	xinxiang	新乡	weibin
卫辉	xinxiang	新乡	weihui
原阳	xinxiang	新乡	yuanyang
封丘	xinxiang	新乡	fengqiu
延津	xinxiang	新乡	yanjin
新乡县	xinxiang	新乡	xinxiang
牧野	xinxiang	新乡	muye
红旗	xinxiang	新乡	hongqi
获嘉	xinxiang	新乡	huojia
辉县	xinxiang	新乡	huixian
长垣	xinxiang	新乡	changyuan
内黄	anyang	安阳	neihuang
北关	anyang	安阳	beiguan
安阳县	anyang	安阳	anyang
文峰	anyang	安阳	wenfeng
林州	anyang	安阳	linzhou
殷都	anyang	安阳	yindou
汤阴	anyang	安阳	tangyin
滑县	anyang	安阳	huaxian
龙安	anyang	安阳	longan
临颍	luohe	漯河	linying
召陵	luohe	漯河	zhaoling
源汇	luohe	漯河	yuanhui
舞阳	luohe	漯河	wuyang
郾城	luohe	漯河	yancheng
内乡	nanyang	南阳	neixiang
南召	nanyang	南阳	nanzhao
卧龙	nanyang	南阳	wolong
唐河	nanyang	南阳	tanghe
宛城	nanyang	南阳	wancheng
新野	nanyang	南阳	xinye
方城	nanyang	南阳	fangcheng
桐柏	nanyang	南阳	tongbai
油田	nanyang	南阳	youtian
淅川	nanyang	南阳	xichuan
社旗	nanyang	南阳	sheqi
西峡	nanyang	南阳	xixia
邓州	nanyang	南阳	dengzhou
镇平	nanyang	南阳	zhenping
下冶	jiyuan	济源	xiaye
五龙口	jiyuan	济源	wulongkou
克井	jiyuan	济源	kejing
北海	jiyuan	济源	beihai
坡头	jiyuan	济源	potou
大峪	jiyuan	济源	dayu
天坛	jiyuan	济源	tiantan
思礼	jiyuan	济源	sili
承留	jiyuan	济源	chengliu
沁园	jiyuan	济源	qinyuan
济水	jiyuan	济源	jishui
玉泉	jiyuan	济源	yuquan
王屋	jiyuan	济源	wangwu
轵城	jiyuan	济源	zhicheng
邵原	jiyuan	济源	shaoyuan
黎林	jiyuan	济源	lilin
其他	jn	济南	qita
历下	jn	济南	lixia
历城	jn	济南	licheng
商河	jn	济南	shanghe
天桥	jn	济南	tianqiao
市中	jn	济南	shizhong
平阴	jn	济南	pingyin
槐荫	jn	济南	huaiyin
济阳	jn	济南	jiyang
章丘	jn	济南	zhangqiu
长清	jn	济南	changqing
高新	jn	济南	gaoxin
即墨	qd	青岛	jimo
四方	qd	青岛	sifang
城阳	qd	青岛	chengyang
崂山	qd	青岛	laoshan
市北	qd	青岛	shibei
市南	qd	青岛	shinan
平度	qd	青岛	pingdu
李沧	qd	青岛	licang
胶南	qd	青岛	jiaonan
胶州	qd	青岛	jiaozhou
莱西	qd	青岛	laixi
黄岛	qd	青岛	huangdao
临淄	zibo	淄博	linzi
博山	zibo	淄博	boshan
周村	zibo	淄博	zhoucun
张店	zibo	淄博	zhangdian
桓台	zibo	淄博	huantai
沂源	zibo	淄博	yiyuan
淄川	zibo	淄博	zichuan
高青	zibo	淄博	gaoqing
台儿庄	zaozhuang	枣庄	taierzhuang
山亭	zaozhuang	枣庄	shanting
峄城	zaozhuang	枣庄	yicheng
市中	zaozhuang	枣庄	shizhong
滕州	zaozhuang	枣庄	tengzhou
薛城	zaozhuang	枣庄	xuecheng
东营区	dongying	东营	dongying
利津	dongying	东营	lijin
垦利	dongying	东营	kenli
广饶	dongying	东营	guangrao
河口	dongying	东营	hekou
开发区	yantai	烟台	kaifaqu
招远	yantai	烟台	zhaoyuan
栖霞	yantai	烟台	qixia
海阳	yantai	烟台	haiyang
牟平	yantai	烟台	mouping
福山	yantai	烟台	fushan
芝罘	yantai	烟台	zhifu
莱山	yantai	烟台	laishan
莱州	yantai	烟台	laizhou
莱阳	yantai	烟台	laiyang
蓬莱	yantai	烟台	penglai
长岛	yantai	烟台	changdao
龙口	yantai	烟台	longkou
临朐	weifang	潍坊	linqu
坊子	weifang	潍坊	fangzi
奎文	weifang	潍坊	kuiwen
安丘	weifang	潍坊	anqiu
寒亭	weifang	潍坊	hanting
寿光	weifang	潍坊	shouguang
昌乐	weifang	潍坊	changle
昌邑	weifang	潍坊	changyi
滨海新区	weifang	潍坊	binhaixinqu
潍城	weifang	潍坊	weicheng
经开区	weifang	潍坊	jingkaiqu
诸城	weifang	潍坊	zhucheng
青州	weifang	潍坊	qingzhou
高密	weifang	潍坊	gaomi
高新区	weifang	潍坊	gaoxinqu
乳山	wei	威海	rushan
文登	wei	威海	wendeng
环翠	wei	威海	huancui
经区	wei	威海	jingqu
荣成	wei	威海	rongcheng
高区	wei	威海	gaoqu
莱城	laiwu	莱芜	laicheng
钢城	laiwu	莱芜	gangcheng
博兴	binzhou	滨州	boxing
惠民	binzhou	滨州	huimin
无棣	binzhou	滨州	wuli
沾化	binzhou	滨州	zhanhua
滨城	binzhou	滨州	bincheng
邹平	binzhou	滨州	zouping
阳信	binzhou	滨州	yangxin
包河	hf	合肥	baohe
庐阳	hf	合肥	luyang
政务	hf	合肥	zhengwu
新站	hf	合肥	xinzhan
滨湖	hf	合肥	binhu
瑶海	hf	合肥	yaohai
经开	hf	合肥	jingkai
肥东	hf	合肥	feidong
肥西	hf	合肥	feixi
蜀山	hf	合肥	shushan
长丰	hf	合肥	zhangfeng
高新	hf	合肥	gaoxin
三山	wuhu	芜湖	sanshan
南陵	wuhu	芜湖	nanling
弋江	wuhu	芜湖	yijiang
繁昌	wuhu	芜湖	fanchang
芜湖县	wuhu	芜湖	wuhuxian
镜湖	wuhu	芜湖	jinghu
鸠江	wuhu	芜湖	jiujiang
五河	bengbu	蚌埠	wuhe
固镇	bengbu	蚌埠	guzhen
怀远	bengbu	蚌埠	huaiyuan
淮上	bengbu	蚌埠	huaishang
禹会	bengbu	蚌埠	yuhui
蚌山	bengbu	蚌埠	bengshan
龙子湖	bengbu	蚌埠	longzihu
当涂	maanshan	马鞍山	dangtu
花山	maanshan	马鞍山	huashan
金家庄	maanshan	马鞍山	jinjiazhuang
雨山	maanshan	马鞍山	yushan
大观	anqing	安庆	daguan
太湖	anqing	安庆	taihu
宜秀	anqing	安庆	yixiu
宿松	anqing	安庆	susong
岳西	anqing	安庆	yuexi
怀宁	anqing	安庆	huaining
望江	anqing	安庆	wangjiang
枞阳	anqing	安庆	congyang
桐城	anqing	安庆	tongcheng
潜山	anqing	安庆	qianshan
迎江	anqing	安庆	yingjiang
全椒	chuzhou	滁州	quanjiao
凤阳	chuzhou	滁州	fengyang
南谯	chuzhou	滁州	nanqiao
天长	chuzhou	滁州	tianzhang
定远	chuzhou	滁州	dingyuan
明光	chuzhou	滁州	mingguang
来安	chuzhou	滁州	laian
琅琊	chuzhou	滁州	langya
临泉	fuyang	阜阳	linquan
太和	fuyang	阜阳	taihe
界首	fuyang	阜阳	jieshou
阜南	fuyang	阜阳	funan
颍上	fuyang	阜阳	yingshang
颍东	fuyang	阜阳	yingdong
颍州	fuyang	阜阳	yingzhou
颍泉	fuyang	阜阳	yingquan
桥	ahsuzhou	宿州	yongqiao
泗县	ahsuzhou	宿州	sixian
灵璧	ahsuzhou	宿州	lingbi
砀山	ahsuzhou	宿州	dangshan
萧县	ahsuzhou	宿州	xiaoxian
含山	chaohu	巢湖	hanshan
和县	chaohu	巢湖	hexian
居巢	chaohu	巢湖	juchao
庐江	chaohu	巢湖	lujiang
无为	chaohu	巢湖	wuwei
寿县	luan	六安	shouxian
舒城	luan	六安	shucheng
裕安	luan	六安	yuan
金安	luan	六安	jinan
金寨	luan	六安	jinzhai
霍山	luan	六安	huoshan
霍邱	luan	六安	huoqiu
三江	liuzhou	柳州	sanjiang
城中	liuzhou	柳州	chengzhong
柳北	liuzhou	柳州	liubei
柳南	liuzhou	柳州	liunan
柳城	liuzhou	柳州	liucheng
柳江	liuzhou	柳州	liujiang
融安	liuzhou	柳州	rongan
融水	liuzhou	柳州	rongshui
鱼峰	liuzhou	柳州	yufeng
鹿寨	liuzhou	柳州	luzhai
七星	gl	桂林	qixing
临桂	gl	桂林	lingui
全州	gl	桂林	quanzhou
兴安	gl	桂林	xingan
叠彩	gl	桂林	diecai
平乐	gl	桂林	pingle
恭城	gl	桂林	gongcheng
永福	gl	桂林	yongfu
灌阳	gl	桂林	guanyang
灵川	gl	桂林	lingchuan
秀峰	gl	桂林	xiufeng
荔浦	gl	桂林	lipu
象山	gl	桂林	xiangshan
资源	gl	桂林	ziyuan
阳朔	gl	桂林	yangshuo
雁山	gl	桂林	yanshan
龙胜	gl	桂林	longsheng
万秀	wuzhou	梧州	wanxiu
岑溪	wuzhou	梧州	cenxi
苍梧	wuzhou	梧州	cangwu
蒙山	wuzhou	梧州	mengshan
藤县	wuzhou	梧州	tengxian
蝶山	wuzhou	梧州	dieshan
长洲	wuzhou	梧州	zhangzhou
浦北	qinzhou	钦州	pubei
灵山	qinzhou	钦州	lingshan
钦北	qinzhou	钦州	qinbei
钦南	qinzhou	钦州	qinnan
平南	guigang	贵港	pingnan
桂平	guigang	贵港	guiping
港北	guigang	贵港	gangbei
港南	guigang	贵港	gangnan
覃塘	guigang	贵港	tantang
兴业	gxyulin	玉林	xingye
北流	gxyulin	玉林	beiliu
博白	gxyulin	玉林	bobai
容县	gxyulin	玉林	rongxian
玉州	gxyulin	玉林	yuzhou
陆川	gxyulin	玉林	luchuan
乐业	baise	百色	leye
凌云	baise	百色	lingyun
右江	baise	百色	youjiang
平果	baise	百色	pingguo
德保	baise	百色	debao
田东	baise	百色	tiandong
田林	baise	百色	tianlin
田阳	baise	百色	tianyang
西林	baise	百色	xilin
那坡	baise	百色	napo
隆林	baise	百色	longlin
靖西	baise	百色	jingxi
东兰	hechi	河池	donglan
凤山	hechi	河池	fengshan
南丹	hechi	河池	nandan
大化	hechi	河池	dahua
天峨	hechi	河池	tiane
宜州	hechi	河池	yizhou
巴马	hechi	河池	bama
环江	hechi	河池	huanjiang
罗城	hechi	河池	luocheng
都安	hechi	河池	douan
金城江	hechi	河池	jinchengjiang
兴宾	laibin	来宾	xingbin
合山	laibin	来宾	heshan
忻城	laibin	来宾	xincheng
武宣	laibin	来宾	wuxuan
象州	laibin	来宾	xiangzhou
金秀	laibin	来宾	jinxiu
上林	nn	南宁	shanglin
兴宁	nn	南宁	xingning
其他	nn	南宁	qita
宾阳	nn	南宁	binyang
横县	nn	南宁	hengxian
武鸣	nn	南宁	wuming
江南	nn	南宁	jiangnan
良庆	nn	南宁	liangqing
西乡塘	nn	南宁	xixiangtang
邕宁	nn	南宁	yongning
隆安	nn	南宁	longan
青秀	nn	南宁	qingxiu
马山	nn	南宁	mashan
其他	hn	海口	qita
琼山	hn	海口	qiongshan
秀英	hn	海口	xiuying
美兰	hn	海口	meilan
龙华	hn	海口	longhua
三亚湾	sanya	三亚	sanyawan
亚龙湾	sanya	三亚	yalongwan
凤凰	sanya	三亚	fenghuang
凤凰岛	sanya	三亚	fenghuangdao
大东海	sanya	三亚	dadonghai
天涯	sanya	三亚	tianya
崖城	sanya	三亚	yacheng
河东	sanya	三亚	hedong
河西	sanya	三亚	hexi
海棠湾	sanya	三亚	haitangwan
田独	sanya	三亚	tiandu
育才	sanya	三亚	yucai
和林格尔	nmg	呼和浩特	helingeer
回民	nmg	呼和浩特	huimin
土默特左	nmg	呼和浩特	tumotezuo
如意开发区	nmg	呼和浩特	ruyikaifaqu
托克托	nmg	呼和浩特	tuoketuo
新城	nmg	呼和浩特	xincheng
武川	nmg	呼和浩特	wuchuan
清水河	nmg	呼和浩特	qingshuihe
玉泉	nmg	呼和浩特	yuquan
赛罕	nmg	呼和浩特	saihan
金山开发区	nmg	呼和浩特	jinshankaifaqu
金川开发区	nmg	呼和浩特	jinchuankaifaqu
金桥开发区	nmg	呼和浩特	jinqiaokaifaqu
东河	baotou	包头	donghe
九原	baotou	包头	jiuyuan
固阳	baotou	包头	guyang
土默特右	baotou	包头	tumoteyou
昆都仑	baotou	包头	kundoulun
白云矿	baotou	包头	baiyunkuang
石拐	baotou	包头	shiguai
达茂	baotou	包头	damao
青山	baotou	包头	qingshan
乌达	wuhai	乌海	wuda
海勃湾	wuhai	乌海	haibowan
海南	wuhai	乌海	hainan
元宝山	chifeng	赤峰	yuanbaoshan
克什克腾	chifeng	赤峰	keshinketeng
喀喇沁	chifeng	赤峰	kalaqin
宁城	chifeng	赤峰	ningcheng
巴林右	chifeng	赤峰	balinyou
巴林左	chifeng	赤峰	balinzuo
敖汉	chifeng	赤峰	aohan
松山	chifeng	赤峰	songshan
林西	chifeng	赤峰	linxi
红山	chifeng	赤峰	hongshan
翁牛特	chifeng	赤峰	wengniute
阿鲁科尔沁	chifeng	赤峰	alukeerqin
奈曼	tongliao	通辽	naiman
库伦	tongliao	通辽	kulun
开鲁	tongliao	通辽	kailu
扎鲁特	tongliao	通辽	zhalute
科尔沁	tongliao	通辽	keerqin
科尔沁左翼中	tongliao	通辽	keerqinzuoyizhong
科尔沁左翼后	tongliao	通辽	keerqinzuoyihou
霍林郭勒	tongliao	通辽	huolinguoleshi
东胜	eerduosi	鄂尔多斯	dongsheng
乌审	eerduosi	鄂尔多斯	wushen
伊金霍洛	eerduosi	鄂尔多斯	yijinhuoluo
准格尔	eerduosi	鄂尔多斯	zhungeer
杭锦	eerduosi	鄂尔多斯	hangjin
达拉特	eerduosi	鄂尔多斯	dalate
鄂托克前	eerduosi	鄂尔多斯	etuokeqian
鄂托克	eerduosi	鄂尔多斯	etuoke
扎兰屯	hulunbeier	呼伦贝尔	zhalantun
新巴尔虎右	hulunbeier	呼伦贝尔	xinbaerhuyou
新巴尔虎左	hulunbeier	呼伦贝尔	xinbaerhuzuo
根河	hulunbeier	呼伦贝尔	genhe
海拉尔	hulunbeier	呼伦贝尔	hailaer
满洲里	hulunbeier	呼伦贝尔	manzhouli
牙克石	hulunbeier	呼伦贝尔	yakeshi
莫力达瓦达翰尔族	hulunbeier	呼伦贝尔	molidawadahanerzu
鄂伦春自治	hulunbeier	呼伦贝尔	elunchun
鄂温克族自治	hulunbeier	呼伦贝尔	ewenkezu
阿荣	hulunbeier	呼伦贝尔	arong
陈巴尔虎	hulunbeier	呼伦贝尔	chenbaerhu
额尔古纳	hulunbeier	呼伦贝尔	eerguna
临河	bayannaoer	巴彦淖尔	linhe
乌拉特中	bayannaoer	巴彦淖尔	wulatezhong
乌拉特前	bayannaoer	巴彦淖尔	wulateqian
乌拉特后	bayannaoer	巴彦淖尔	wulatehou
五原	bayannaoer	巴彦淖尔	wuyuan
杭锦后	bayannaoer	巴彦淖尔	hangjinhou
磴口	bayannaoer	巴彦淖尔	dengkou
丰镇	wulanchabu	乌兰察布	fengzhenshi
兴和	wulanchabu	乌兰察布	xinghe
凉城	wulanchabu	乌兰察布	liangcheng
化德	wulanchabu	乌兰察布	huade
卓资	wulanchabu	乌兰察布	zhuozi
商都	wulanchabu	乌兰察布	shangdou
四子王	wulanchabu	乌兰察布	siziwang
察哈尔右翼中	wulanchabu	乌兰察布	chahaeryouyizhong
察哈尔右翼前	wulanchabu	乌兰察布	chahaeryouyiqian
察哈尔右翼后	wulanchabu	乌兰察布	chahaeryouyihou
集宁	wulanchabu	乌兰察布	jining
乌兰浩特	xingan	兴安	wulanhaote
扎赉特	xingan	兴安	zhalaite
科尔沁右翼中	xingan	兴安	keerqinyouyizhong
科尔沁右翼前	xingan	兴安	keerqinyouyiqian
突泉	xingan	兴安	tuquan
阿尔山	xingan	兴安	aershan
万柏林	ty	太原	wanbailin
古交	ty	太原	gujiao
娄烦	ty	太原	loufan
小店	ty	太原	xiaodian
尖草坪	ty	太原	jiancaoping
晋源	ty	太原	jinyuan
杏花岭	ty	太原	xinghualing
清徐	ty	太原	qingxu
迎泽	ty	太原	yingze
阳曲	ty	太原	yangqu
南郊	datong	大同	nanjiao
城区	datong	大同	chengqu
大同县	datong	大同	datongxian
天镇	datong	大同	tianzhen
左云	datong	大同	zuoyun
广灵	datong	大同	guangling
新荣	datong	大同	xinrong
浑源	datong	大同	hunyuan
灵丘	datong	大同	lingqiu
矿区	datong	大同	kuangqu
阳高	datong	大同	yanggao
城区	yangquan	阳泉	chengqu
平定	yangquan	阳泉	pingding
盂县	yangquan	阳泉	yuxian
矿区	yangquan	阳泉	kuangqu
郊区	yangquan	阳泉	jiaoqu
城区	changzhi	长治	chengqu
壶关	changzhi	长治	huguan
屯留	changzhi	长治	tunliu
平顺	changzhi	长治	pingshun
武乡	changzhi	长治	wuxiang
沁县	changzhi	长治	qinxian
沁源	changzhi	长治	qinyuan
潞城	changzhi	长治	lucheng
襄垣	changzhi	长治	xiangyuan
郊区	changzhi	长治	jiaoqu
长子	changzhi	长治	changzi
长治县	changzhi	长治	zhangzhixian
黎城	changzhi	长治	licheng
城区	jincheng	晋城	chengqu
沁水	jincheng	晋城	qinshui
泽州	jincheng	晋城	zezhou
阳城	jincheng	晋城	yangcheng
陵川	jincheng	晋城	lingchuan
高平	jincheng	晋城	gaoping
右玉	shuozhou	朔州	youyu
山阴	shuozhou	朔州	shanyin
平鲁	shuozhou	朔州	pinglu
应县	shuozhou	朔州	yingxian
怀仁	shuozhou	朔州	huairen
朔城	shuozhou	朔州	shuocheng
介休	jinzhong	晋中	jiexiu
和顺	jinzhong	晋中	heshun
太谷	jinzhong	晋中	taigu
寿阳	jinzhong	晋中	shouyang
左权	jinzhong	晋中	zuoquan
平遥	jinzhong	晋中	pingyao
昔阳	jinzhong	晋中	xiyang
榆次	jinzhong	晋中	yuci
榆社	jinzhong	晋中	yushe
灵石	jinzhong	晋中	lingshi
祁县	jinzhong	晋中	qixian
万荣	yuncheng	运城	wanrong
临猗	yuncheng	运城	linyi
垣曲	yuncheng	运城	yuanqu
夏县	yuncheng	运城	xiaxian
平陆	yuncheng	运城	pinglu
新绛	yuncheng	运城	xinjiang
永济	yuncheng	运城	yongji
河津	yuncheng	运城	hejin
盐湖	yuncheng	运城	yanhu
稷山	yuncheng	运城	jishan
绛县	yuncheng	运城	jiangxian
芮城	yuncheng	运城	ruicheng
闻喜	yuncheng	运城	wenxi
五台	xinzhou	忻州	wutai
五寨	xinzhou	忻州	wuzhai
代县	xinzhou	忻州	daixian
保德	xinzhou	忻州	baode
偏关	xinzhou	忻州	pianguan
原平	xinzhou	忻州	yuanping
宁武	xinzhou	忻州	ningwu
定襄	xinzhou	忻州	dingxiang
岢岚	xinzhou	忻州	kelan
忻府	xinzhou	忻州	xinfu
河曲	xinzhou	忻州	hequ
神池	xinzhou	忻州	shenchi
繁峙	xinzhou	忻州	fanzhi
静乐	xinzhou	忻州	jingle
乡宁	linfen	临汾	xiangning
侯马	linfen	临汾	houma
古县	linfen	临汾	guxian
吉县	linfen	临汾	jixian
大宁	linfen	临汾	daning
安泽	linfen	临汾	anze
尧都	linfen	临汾	yaodou
曲沃	linfen	临汾	quwo
永和	linfen	临汾	yonghe
汾西	linfen	临汾	fenxi
洪洞	linfen	临汾	hongdong
浮山	linfen	临汾	fushan
翼城	linfen	临汾	yicheng
蒲县	linfen	临汾	puxian
襄汾	linfen	临汾	xiangfen
隰县	linfen	临汾	xixian
霍州	linfen	临汾	huozhou
兴庆	yc	银川	xingqing
永宁	yc	银川	yongning
灵武	yc	银川	lingwu
西夏	yc	银川	xixia
贺兰	yc	银川	helan
金凤	yc	银川	jinfeng
七里河	lz	兰州	qilihe
城关	lz	兰州	chengguan
安宁	lz	兰州	anning
榆中	lz	兰州	yuzhong
永登	lz	兰州	yongdeng
皋兰	lz	兰州	gaolan
红古	lz	兰州	honggu
西固	lz	兰州	xigu
永昌	jinchang	金昌	yongchang
金川	jinchang	金昌	jinchuan
会宁	baiyin	白银	huining
平川	baiyin	白银	pingchuan
景泰	baiyin	白银	jingtai
白银区	baiyin	白银	baiyinqu
靖远	baiyin	白银	jingyuan
北道	tianshui	天水	beidao
张家川	tianshui	天水	zhangjiachuan
武山	tianshui	天水	wushan
清水	tianshui	天水	qingshui
甘谷	tianshui	天水	gangu
秦城	tianshui	天水	qinzhou
秦安	tianshui	天水	qinan
凉州	wuwei	武威	liangzhou
古浪	wuwei	武威	gulang
天祝	wuwei	武威	tianzhu
民勤	wuwei	武威	minqin
临泽	zhangye	张掖	linze
山丹	zhangye	张掖	shandan
民乐	zhangye	张掖	minle
甘州	zhangye	张掖	ganzhou
肃南	zhangye	张掖	sunan
高台	zhangye	张掖	gaotai
华亭	pingliang	平凉	huating
崆峒	pingliang	平凉	kongtong
崇信	pingliang	平凉	chongxin
庄浪	pingliang	平凉	zhuanglang
泾川	pingliang	平凉	jingchuan
灵台	pingliang	平凉	lingtai
静宁	pingliang	平凉	jingning
敦煌	jiuquan	酒泉	dunhuang
玉门	jiuquan	酒泉	yumen
瓜州	jiuquan	酒泉	guazhou
肃北	jiuquan	酒泉	subei
肃州	jiuquan	酒泉	suzhou
金塔	jiuquan	酒泉	jinta
阿克塞	jiuquan	酒泉	akesai
华池	qingyang	庆阳	huachi
合水	qingyang	庆阳	heshui
宁县	qingyang	庆阳	ningxian
庆城	qingyang	庆阳	qingcheng
正宁	qingyang	庆阳	zhengning
环县	qingyang	庆阳	huanxian
西峰	qingyang	庆阳	xifeng
镇原	qingyang	庆阳	zhenyuan
临洮	dingxi	定西	lintao
安定	dingxi	定西	anding
岷县	dingxi	定西	minxian
渭源	dingxi	定西	weiyuan
漳县	dingxi	定西	zhangxian
通渭	dingxi	定西	tongwei
陇西	dingxi	定西	longxi
临潼	xa	西安	lintong
其他	xa	西安	qita
周至	xa	西安	zhouzhi
户县	xa	西安	huxian
新城	xa	西安	xincheng
曲江新区	xa	西安	qujiangxinqu
未央	xa	西安	weiyang
沣渭新区	xa	西安	fengweixinqu
哄	xa	西安	chanba
灞桥	xa	西安	baqiao
碑林	xa	西安	beilin
莲湖	xa	西安	lianhu
蓝田	xa	西安	lantian
长安	xa	西安	changan
阎良	xa	西安	yanliang
雁塔	xa	西安	yanta
高新	xa	西安	gaoxin
高陵	xa	西安	gaoling
印台	tongchuan	铜川	yintai
宜君	tongchuan	铜川	yijun
王益	tongchuan	铜川	wangyi
耀州	tongchuan	铜川	yaozhou
凤县	baoji	宝鸡	fengxian
凤翔	baoji	宝鸡	fengxiang
千阳	baoji	宝鸡	qianyang
太白	baoji	宝鸡	taibai
岐山	baoji	宝鸡	qishan
扶风	baoji	宝鸡	fufeng
渭滨	baoji	宝鸡	weibin
眉县	baoji	宝鸡	meixian
金台	baoji	宝鸡	jintai
陇县	baoji	宝鸡	longxian
陈仓	baoji	宝鸡	chencang
麟游	baoji	宝鸡	linyou
三原	xianyang	咸阳	sanyuan
乾县	xianyang	咸阳	qianxian
兴平	xianyang	咸阳	xingping
彬县	xianyang	咸阳	binxian
旬邑	xianyang	咸阳	xunyi
杨陵	xianyang	咸阳	yangling
武功	xianyang	咸阳	wugong
永寿	xianyang	咸阳	yongshou
泾阳	xianyang	咸阳	jingyang
淳化	xianyang	咸阳	chunhua
渭城	xianyang	咸阳	weicheng
礼泉	xianyang	咸阳	liquan
秦都	xianyang	咸阳	qindou
长武	xianyang	咸阳	changwu
临渭	weinan	渭南	linwei
华县	weinan	渭南	huaxian
华阴	weinan	渭南	huayin
合阳	weinan	渭南	heyang
大荔	weinan	渭南	dali
富平	weinan	渭南	fuping
潼关	weinan	渭南	tongguan
澄城	weinan	渭南	chengcheng
白水	weinan	渭南	baishui
蒲城	weinan	渭南	pucheng
韩城	weinan	渭南	hancheng
吴起	yanan	延安	wuqi
子长	yanan	延安	zizhang
安塞	yanan	延安	ansai
宜川	yanan	延安	yichuan
宝塔	yanan	延安	baota
富县	yanan	延安	fuxian
延川	yanan	延安	yanchuan
延长	yanan	延安	yanchang
志丹	yanan	延安	zhidan
洛川	yanan	延安	luochuan
甘泉	yanan	延安	ganquan
黄陵	yanan	延安	huangling
黄龙	yanan	延安	huanglong
佛坪	hanzhong	汉中	foping
勉县	hanzhong	汉中	mianxian
南郑	hanzhong	汉中	nanzheng
城固	hanzhong	汉中	chenggu
宁强	hanzhong	汉中	ningqiang
汉台	hanzhong	汉中	hantai
洋县	hanzhong	汉中	yangxian
留坝	hanzhong	汉中	liuba
略阳	hanzhong	汉中	lueyang
西乡	hanzhong	汉中	xixiang
镇巴	hanzhong	汉中	zhenba
佳县	sxyulin	榆林	jiaxian
吴堡	sxyulin	榆林	wubao
子洲	sxyulin	榆林	zizhou
定边	sxyulin	榆林	dingbian
府谷	sxyulin	榆林	fugu
榆阳	sxyulin	榆林	yuyang
横山	sxyulin	榆林	hengshan
清涧	sxyulin	榆林	qingjian
神木	sxyulin	榆林	shenmu
米脂	sxyulin	榆林	mizhi
绥德	sxyulin	榆林	suide
靖边	sxyulin	榆林	jingbian
宁陕	ankang	安康	ningshan
岚皋	ankang	安康	langao
平利	ankang	安康	pingli
旬阳	ankang	安康	xunyang
汉滨	ankang	安康	hanbin
汉阴	ankang	安康	hanyin
白河	ankang	安康	baihe
石泉	ankang	安康	shiquan
紫阳	ankang	安康	ziyang
镇坪	ankang	安康	zhenping
丹凤	shangluo	商洛	danfeng
商南	shangluo	商洛	shangnan
商州	shangluo	商洛	shangzhou
山阳	shangluo	商洛	shanyang
柞水	shangluo	商洛	zhashui
洛南	shangluo	商洛	luonan
镇安	shangluo	商洛	zhenan
城东	xn	西宁	chengdong
城中	xn	西宁	chengzhong
城北	xn	西宁	chengbei
城西	xn	西宁	chengxi
大通自治县	xn	西宁	datongzizhixian
湟中	xn	西宁	huangzhong
湟源	xn	西宁	huangyuan
乐都	haidong	海东	ledu
互助	haidong	海东	huzhu
化隆	haidong	海东	hualong
平安	haidong	海东	pingan
循化	haidong	海东	xunhua
民和	haidong	海东	minhe
刚察	haibei	海北	gangcha
海晏	haibei	海北	haiyan
祁连	haibei	海北	qilian
门源	haibei	海北	menyuan
同仁	huangnan	黄南	tongren
尖扎	huangnan	黄南	jianzha
河南	huangnan	黄南	henan
泽库	huangnan	黄南	zeku
共和	hainanzhou	海南州	gonghe
兴海	hainanzhou	海南州	xinghai
同德	hainanzhou	海南州	tongde
贵南	hainanzhou	海南州	guinan
贵德	hainanzhou	海南州	guide
久治	guoluo	果洛	jiuzhi
玛多	guoluo	果洛	maduo
玛沁	guoluo	果洛	maqin
班玛	guoluo	果洛	banma
甘德	guoluo	果洛	gande
达日	guoluo	果洛	dari
囊谦	yushu	玉树	nangqian
曲麻莱	yushu	玉树	qumalai
杂多	yushu	玉树	zaduo
治多	yushu	玉树	zhiduo
玉树县	yushu	玉树	yushuxian
称多	yushu	玉树	chengduo
乌兰	haixi	海西	wulan
冷湖行委	haixi	海西	lenghuhangwei
大柴旦行委	haixi	海西	dachaidanhangwei
天峻	haixi	海西	tianjun
德令哈	haixi	海西	delingha
格尔木	haixi	海西	geermu
茫崖行委	haixi	海西	mangyahangwei
都兰	haixi	海西	doulan
东西湖	wh	武汉	dongxihu
新洲	wh	武汉	xinzhou
武昌	wh	武汉	wuchang
汉南	wh	武汉	hannan
汉阳	wh	武汉	hanyang
江夏	wh	武汉	jiangxia
江岸	wh	武汉	jiangan
江汉	wh	武汉	jianghan
沌口开发区	wh	武汉	jingjijishukaifaqu
洪山	wh	武汉	hongshan
~口	wh	武汉	qiaokou
蔡甸	wh	武汉	caidian
青山	wh	武汉	qingshan
黄陂	wh	武汉	huangbei
下陆	huangshi	黄石	xialu
大冶	huangshi	黄石	daye
西塞山	huangshi	黄石	xisaishan
铁山	huangshi	黄石	tieshan
阳新	huangshi	黄石	yangxin
黄石港	huangshi	黄石	huangshigang
保康	xiangyang	襄阳	baokang
南漳	xiangyang	襄阳	nanzhang
宜城	xiangyang	襄阳	yicheng
枣阳	xiangyang	襄阳	zaoyang
樊城	xiangyang	襄阳	fancheng
老河口	xiangyang	襄阳	laohekou
襄城	xiangyang	襄阳	xiangcheng
襄州	xiangyang	襄阳	xiangyang
谷城	xiangyang	襄阳	gucheng
丹江口	shiyan	十堰	danjiangkou
张湾	shiyan	十堰	zhangwan
房县	shiyan	十堰	fangxian
竹山	shiyan	十堰	zhushan
竹溪	shiyan	十堰	zhuxi
茅箭	shiyan	十堰	maojian
郧县	shiyan	十堰	yunxian
郧西	shiyan	十堰	yunxi
公安	jingzhou	荆州	gongan
松滋	jingzhou	荆州	songzi
江陵	jingzhou	荆州	jiangling
沙市	jingzhou	荆州	shashi
洪湖	jingzhou	荆州	honghu
监利	jingzhou	荆州	jianli
石首	jingzhou	荆州	shishou
荆州区	jingzhou	荆州	jingzhou
东山开发区	yichang	宜昌	dongshankaifaqu
五峰	yichang	宜昌	wufeng
伍家岗	yichang	宜昌	wujiagang
兴山	yichang	宜昌	xingshan
夷陵	yichang	宜昌	yiling
宜都	yichang	宜昌	yidou
当阳	yichang	宜昌	dangyang
枝江	yichang	宜昌	zhijiang
点军	yichang	宜昌	dianjun
V亭	yichang	宜昌	xiaoting
秭归	yichang	宜昌	zigui
西陵	yichang	宜昌	xiling
远安	yichang	宜昌	yuanan
长阳	yichang	宜昌	zhangyang
东宝	jingmen	荆门	dongbao
京山	jingmen	荆门	jingshan
掇刀	jingmen	荆门	duodao
沙洋	jingmen	荆门	shayang
钟祥	jingmen	荆门	zhongxiang
华容	ezhou	鄂州	huarong
梁子湖	ezhou	鄂州	liangzihu
鄂城	ezhou	鄂州	echeng
三伏潭	xiantao	仙桃	sanfutan
r河	xiantao	仙桃	louhe
工业园	xiantao	仙桃	gongyeyuan
干河	xiantao	仙桃	ganhe
张沟	xiantao	仙桃	zhanggou
彭场	xiantao	仙桃	pengchang
杨林尾	xiantao	仙桃	yanglinwei
毛嘴	xiantao	仙桃	maozui
沔城	xiantao	仙桃	miancheng
沙嘴	xiantao	仙桃	shazui
沙湖	xiantao	仙桃	sanhu
胡场	xiantao	仙桃	huchang
西流河	xiantao	仙桃	xiliuhe
通海口	xiantao	仙桃	tonghai
郑场	xiantao	仙桃	zhengchang
郭河	xiantao	仙桃	guohe
长每	xiantao	仙桃	changtangkou
陈场	xiantao	仙桃	chenchang
龙华山	xiantao	仙桃	longhuanshan
周矶	qianjiang	潜江	zhouji
园林	qianjiang	潜江	yuanlin
广华	qianjiang	潜江	guanghua
张金	qianjiang	潜江	jinzhen
杨市	qianjiang	潜江	yangshi
泽口	qianjiang	潜江	zekou
浩口	qianjiang	潜江	haokou
渔洋	qianjiang	潜江	yuyang
熊口	qianjiang	潜江	xiongkou
王场	qianjiang	潜江	wangchang
积玉口	qianjiang	潜江	jiyukou
竹根滩	qianjiang	潜江	zhugentan
老新	qianjiang	潜江	laoxin
高石碑	qianjiang	潜江	gaoshibei
龙湾	qianjiang	潜江	longwan
其他	cs	长沙	qita
天心	cs	长沙	tianxin
宁乡	cs	长沙	ningxiang
岳麓	cs	长沙	yuelu
开福	cs	长沙	kaifu
星沙	cs	长沙	shaxing
望城	cs	长沙	wangcheng
浏阳	cs	长沙	liuyang
经济开发区	cs	长沙	jingjikaifa
芙蓉	cs	长沙	furong
长沙县	cs	长沙	changshaxian
雨花	cs	长沙	yuhua
天元	zhuzhou	株洲	tianyuan
攸县	zhuzhou	株洲	youxian
株洲县	zhuzhou	株洲	zhuzhou
炎陵	zhuzhou	株洲	yanling
石峰	zhuzhou	株洲	shifeng
芦淞	zhuzhou	株洲	lusong
茶陵	zhuzhou	株洲	chaling
荷塘	zhuzhou	株洲	hetang
醴陵	zhuzhou	株洲	liling
岳塘	xiangtan	湘潭	yuetang
湘乡	xiangtan	湘潭	xiangxiang
湘潭县	xiangtan	湘潭	xiangtan
雨湖	xiangtan	湘潭	yuhu
韶山	xiangtan	湘潭	shaoshan
南岳	hengyang	衡阳	nanyue
常宁	hengyang	衡阳	changning
珠晖	hengyang	衡阳	zhuhui
石鼓	hengyang	衡阳	shigu
祁东	hengyang	衡阳	qidong
耒阳	hengyang	衡阳	leiyang
蒸湘	hengyang	衡阳	zhengxiang
衡东	hengyang	衡阳	hengdong
衡南	hengyang	衡阳	hengnan
衡山	hengyang	衡阳	hengshan
衡阳县	hengyang	衡阳	hengyang
雁峰	hengyang	衡阳	yanfeng
北塔	shaoyang	邵阳	beita
双清	shaoyang	邵阳	shuangqing
城步	shaoyang	邵阳	chengbu
大祥	shaoyang	邵阳	daxiang
新宁	shaoyang	邵阳	xinning
新邵	shaoyang	邵阳	xinshao
武冈	shaoyang	邵阳	wugang
洞口	shaoyang	邵阳	dongkou
绥宁	shaoyang	邵阳	suining
邵东	shaoyang	邵阳	shaodong
邵阳县	shaoyang	邵阳	shaoyangxian
隆回	shaoyang	邵阳	longhui
临湘	yueyang	岳阳	linxiang
云溪	yueyang	岳阳	yunxi
华容	yueyang	岳阳	huarong
君山	yueyang	岳阳	junshan
岳阳县	yueyang	岳阳	yueyangxian
岳阳楼	yueyang	岳阳	yueyanglou
平江	yueyang	岳阳	pingjiang
汨罗	yueyang	岳阳	miluo
湘阴	yueyang	岳阳	xiangyin
临澧	changde	常德	linli
安乡	changde	常德	anxiang
桃源	changde	常德	taoyuan
武陵	changde	常德	wuling
汉寿	changde	常德	hanshou
津市	changde	常德	jinshi
澧县	changde	常德	lixian
石门	changde	常德	shimen
鼎城	changde	常德	dingcheng
临武	chenzhou	郴州	linwu
北湖	chenzhou	郴州	beihu
嘉禾	chenzhou	郴州	jiahe
安仁	chenzhou	郴州	anren
宜章	chenzhou	郴州	yizhang
桂东	chenzhou	郴州	guidong
桂阳	chenzhou	郴州	guiyang
永兴	chenzhou	郴州	yongxing
汝城	chenzhou	郴州	rucheng
苏仙	chenzhou	郴州	suxian
资兴	chenzhou	郴州	zixing
东安	yongzhou	永州	dongan
冷水滩	yongzhou	永州	lengshuitan
双牌	yongzhou	永州	shuangpai
宁远	yongzhou	永州	ningyuan
新田	yongzhou	永州	xintian
江华	yongzhou	永州	jianghua
江永	yongzhou	永州	jiangyong
祁阳	yongzhou	永州	qiyang
蓝山	yongzhou	永州	lanshan
道县	yongzhou	永州	daoxian
零陵	yongzhou	永州	lingling
冷水江	loudi	娄底	lengshuijiang
双峰	loudi	娄底	shuangfeng
娄星	loudi	娄底	louxing
新化	loudi	娄底	xinhua
涟源	loudi	娄底	lianyuan
东湖	nc	南昌	donghu
南昌县	nc	南昌	nanchang
安义	nc	南昌	anyi
新建	nc	南昌	xinjian
昌北	nc	南昌	changbei
湾里	nc	南昌	wanli
红谷滩新区	nc	南昌	honggutanxinqu
西湖	nc	南昌	xihu
进贤	nc	南昌	jinxian
青云谱	nc	南昌	qingyunpu
青山湖	nc	南昌	qingshanhu
高新区	nc	南昌	gaoxinqu
乐平	jingdezhen	景德镇	leping
昌江	jingdezhen	景德镇	changjiang
浮梁	jingdezhen	景德镇	fuliang
珠山	jingdezhen	景德镇	zhushan
上栗	pingxiang	萍乡	shangli
安源	pingxiang	萍乡	anyuan
湘东	pingxiang	萍乡	xiangdong
芦溪	pingxiang	萍乡	luxi
莲花	pingxiang	萍乡	lianhua
九江县	jiujiang	九江	jiujiang
修水	jiujiang	九江	xiushui
庐山	jiujiang	九江	lushan
彭泽	jiujiang	九江	pengze
德安	jiujiang	九江	dean
星子	jiujiang	九江	xingzi
武宁	jiujiang	九江	wuning
永修	jiujiang	九江	yongxiu
浔阳	jiujiang	九江	xunyang
湖口	jiujiang	九江	hukou
瑞昌	jiujiang	九江	ruichang
都昌	jiujiang	九江	douchang
分宜	xinyu	新余	fenyi
渝水	xinyu	新余	yushui
余江	yingtan	鹰潭	yujiang
月湖	yingtan	鹰潭	yuehu
贵溪	yingtan	鹰潭	guixi
上犹	ganzhou	赣州	shangyou
于都	ganzhou	赣州	yudou
会昌	ganzhou	赣州	huichang
信丰	ganzhou	赣州	xinfeng
全南	ganzhou	赣州	quannan
兴国	ganzhou	赣州	xingguo
南康	ganzhou	赣州	nankang
大余	ganzhou	赣州	dayu
宁都	ganzhou	赣州	ningdou
安远	ganzhou	赣州	anyuan
定南	ganzhou	赣州	dingnan
寻乌	ganzhou	赣州	xunwu
崇义	ganzhou	赣州	chongyi
瑞金	ganzhou	赣州	ruijin
石城	ganzhou	赣州	shicheng
章贡	ganzhou	赣州	zhanggong
赣县	ganzhou	赣州	ganxian
龙南	ganzhou	赣州	longnan
万安	jian	吉安	wanan
井冈山	jian	吉安	jinggangshan
吉安县	jian	吉安	jianxian
吉州	jian	吉安	jizhou
吉水	jian	吉安	jishui
安福	jian	吉安	anfu
峡江	jian	吉安	xiajiang
新干	jian	吉安	xingan
永丰	jian	吉安	yongfeng
永新	jian	吉安	yongxin
泰和	jian	吉安	taihe
遂川	jian	吉安	suichuan
青原	jian	吉安	qingyuan
万载	jxyichun	宜春	wanzai
上高	jxyichun	宜春	shanggao
丰城	jxyichun	宜春	fengcheng
奉新	jxyichun	宜春	fengxin
宜丰	jxyichun	宜春	yifeng
樟树	jxyichun	宜春	zhangshu
袁州	jxyichun	宜春	yuanzhou
铜鼓	jxyichun	宜春	tonggu
靖安	jxyichun	宜春	jingan
高安	jxyichun	宜春	gaoan
东乡	jxfuzhou	抚州	dongxiang
临川	jxfuzhou	抚州	linchuan
乐安	jxfuzhou	抚州	lean
南丰	jxfuzhou	抚州	nanfeng
南城	jxfuzhou	抚州	nancheng
宜黄	jxfuzhou	抚州	yihuang
崇仁	jxfuzhou	抚州	chongren
广昌	jxfuzhou	抚州	guangchang
资溪	jxfuzhou	抚州	zixi
金溪	jxfuzhou	抚州	jinxi
黎川	jxfuzhou	抚州	lichuan
万年	shangrao	上饶	wannian
上饶县	shangrao	上饶	shangrao
余干	shangrao	上饶	yugan
信州	shangrao	上饶	xinzhou
婺源	shangrao	上饶	wuyuan
广丰	shangrao	上饶	guangfeng
弋阳	shangrao	上饶	yiyang
德兴	shangrao	上饶	dexing
横峰	shangrao	上饶	hengfeng
玉山	shangrao	上饶	yushan
鄱阳	shangrao	上饶	poyang
铅山	shangrao	上饶	qianshan
东川	km	昆明	dongchuan
五华	km	昆明	wuhua
呈贡	km	昆明	chenggong
安宁	km	昆明	anning
官渡	km	昆明	guandu
宜良	km	昆明	yiliang
富民	km	昆明	fumin
寻甸	km	昆明	xundian
嵩明	km	昆明	songming
晋宁	km	昆明	jinning
盘龙	km	昆明	panlong
石林	km	昆明	shilin
禄劝	km	昆明	luquan
西山	km	昆明	xishan
会泽	qujing	曲靖	huize
宣威	qujing	曲靖	xuanwei
富源	qujing	曲靖	fuyuan
师宗	qujing	曲靖	shizong
沾益	qujing	曲靖	zhayi
罗平	qujing	曲靖	luoping
陆良	qujing	曲靖	luliang
马龙	qujing	曲靖	malong
麒麟	qujing	曲靖	qilin
元江	yuxi	玉溪	yuanjiang
华宁	yuxi	玉溪	huaning
峨山	yuxi	玉溪	eshan
新平	yuxi	玉溪	xinping
易门	yuxi	玉溪	yimen
江川	yuxi	玉溪	jiangchuan
澄江	yuxi	玉溪	chengjiang
红塔	yuxi	玉溪	hongta
通海	yuxi	玉溪	tonghai
施甸	baoshan	保山	shidian
昌宁	baoshan	保山	changning
腾冲	baoshan	保山	tengchong
隆阳	baoshan	保山	longyang
龙陵	baoshan	保山	longling
大关	zhaotong	昭通	daguan
威信	zhaotong	昭通	weixin
巧家	zhaotong	昭通	qiaojia
彝良	zhaotong	昭通	yiliang
昭阳	zhaotong	昭通	zhaoyang
水富	zhaotong	昭通	shuifu
永善	zhaotong	昭通	yongshan
盐津	zhaotong	昭通	yanjin
绥江	zhaotong	昭通	suijiang
镇雄	zhaotong	昭通	zhenxiong
鲁甸	zhaotong	昭通	ludian
华坪	lijiang	丽江	huaping
古城	lijiang	丽江	gucheng
宁蒗	lijiang	丽江	ninglang
永胜	lijiang	丽江	yongsheng
玉龙	lijiang	丽江	yulong
墨江	puer	普洱	muojiang
孟连	puer	普洱	menglian
宁洱	puer	普洱	ninger
思茅	puer	普洱	maosi
景东	puer	普洱	jingdong
景谷	puer	普洱	jinggu
江城	puer	普洱	jiangcheng
澜沧	puer	普洱	lancang
西盟	puer	普洱	ximeng
镇沅	puer	普洱	zhenyuan
临翔	lincang	临沧	linxiang
云县	lincang	临沧	yunxian
凤庆	lincang	临沧	fengqing
双江	lincang	临沧	shuangjiang
永德	lincang	临沧	yongde
沧源	lincang	临沧	cangyuan
耿马	lincang	临沧	gengma
镇康	lincang	临沧	zhenkang
丘北	wenshan	文山	qiubei
富宁	wenshan	文山	funing
广南	wenshan	文山	guangnan
文山市	wenshan	文山	wenshan
砚山	wenshan	文山	yanshan
西畴	wenshan	文山	xichou
马关	wenshan	文山	maguan
麻栗坡	wenshan	文山	malipo
个旧	honghe	红河	gejiu
元阳	honghe	红河	yuanyang
屏边	honghe	红河	pingbian
建水	honghe	红河	jianshui
开远	honghe	红河	kaiyuan
弥勒	honghe	红河	mile
河口	honghe	红河	hekou
泸西	honghe	红河	luxi
石屏	honghe	红河	shiping
红河县	honghe	红河	honghe
绿春	honghe	红河	lvchun
蒙自	honghe	红河	mengzi
金平	honghe	红河	jinping
勐海	xishuangbanna	西双版纳	menghai
勐腊	xishuangbanna	西双版纳	mengla
景洪	xishuangbanna	西双版纳	jinghong
元谋	chuxiong	楚雄	yuanmou
南华	chuxiong	楚雄	nanhua
双柏	chuxiong	楚雄	shuangbai
大姚	chuxiong	楚雄	dayao
姚安	chuxiong	楚雄	yaoan
楚雄市	chuxiong	楚雄	chuxiong
武定	chuxiong	楚雄	wuding
永仁	chuxiong	楚雄	yongren
牟定	chuxiong	楚雄	mouding
禄丰	chuxiong	楚雄	lufeng
云龙	dali	大理	yunlong
剑川	dali	大理	jianchuan
南涧	dali	大理	nanjian
大理市	dali	大理	dali
宾川	dali	大理	binzhou
巍山	dali	大理	weishan
弥渡	dali	大理	midu
永平	dali	大理	yongping
洱源	dali	大理	eryuan
漾濞	dali	大理	yangbi
祥云	dali	大理	xiangyun
鹤庆	dali	大理	heqing
梁河	dehong	德宏	lianghe
潞西	dehong	德宏	luxi
瑞丽	dehong	德宏	ruili
盈江	dehong	德宏	yingjiang
陇川	dehong	德宏	longchuan
兰坪	nujiang	怒江	lanping
泸水	nujiang	怒江	lushui
福贡	nujiang	怒江	fugong
贡山	nujiang	怒江	gongshan
德钦	diqing	迪庆	deqin
维西	diqing	迪庆	weixi
香格里拉	diqing	迪庆	xianggelila
东山	xj	乌鲁木齐	dongshan
乌鲁木齐县	xj	乌鲁木齐	wulumuqi
天山	xj	乌鲁木齐	tianshan
头屯河	xj	乌鲁木齐	toutunhe
开发	xj	乌鲁木齐	kaifa
新市	xj	乌鲁木齐	xinshi
水磨沟	xj	乌鲁木齐	shuimogou
沙依巴克	xj	乌鲁木齐	shayibake
米东	xj	乌鲁木齐	midong
达坂城	xj	乌鲁木齐	dabancheng
乌尔禾	kelamayi	克拉玛依	wuerhe
克拉玛依区	kelamayi	克拉玛依	kelamayi
独山子	kelamayi	克拉玛依	dushanzi
白碱滩	kelamayi	克拉玛依	baijiantan
吐鲁番市	tulufan	吐鲁番	tulufan
托克逊	tulufan	吐鲁番	tuokexun
鄯善	tulufan	吐鲁番	shanshan
伊吾	hami	哈密	yiwu
哈密市	hami	哈密	hami
巴里坤	hami	哈密	balikun
于田	hetian	和田	yutian
和田县	hetian	和田	hetianxian
和田市	hetian	和田	hetian
墨玉	hetian	和田	moyu
民丰	hetian	和田	minfeng
洛浦	hetian	和田	luopu
皮山	hetian	和田	pishan
策勒	hetian	和田	cele
乌什	akesu	阿克苏	wushen
库车	akesu	阿克苏	kuche
拜城	akesu	阿克苏	baicheng
新和	akesu	阿克苏	xinhe
柯坪	akesu	阿克苏	keping
沙雅	akesu	阿克苏	shaya
温宿	akesu	阿克苏	wensu
阿克苏市	akesu	阿克苏	akesu
阿瓦提	akesu	阿克苏	awati
伽师	kashi	喀什	jiashi
叶城	kashi	喀什	yecheng
喀什市	kashi	喀什	kashi
塔什库尔	kashi	喀什	tashikuer
岳普湖	kashi	喀什	yuepuhu
巴楚	kashi	喀什	bachu
泽普	kashi	喀什	zepu
疏勒	kashi	喀什	shule
疏附	kashi	喀什	shufu
英吉沙	kashi	喀什	yingjisha
莎车	kashi	喀什	shache
麦盖提	kashi	喀什	maigaiti
乌恰	kezilesu	克孜勒苏	wuqia
阿克陶	kezilesu	克孜勒苏	aketao
阿合奇	kezilesu	克孜勒苏	aheqi
阿图什	kezilesu	克孜勒苏	atushi
且末	bayinguoleng	巴音郭楞	qiemo
博湖	bayinguoleng	巴音郭楞	bohu
和硕	bayinguoleng	巴音郭楞	heshuo
和静	bayinguoleng	巴音郭楞	hejing
尉犁	bayinguoleng	巴音郭楞	weili
库尔勒	bayinguoleng	巴音郭楞	kuerle
焉耆	bayinguoleng	巴音郭楞	yanqi
若羌	bayinguoleng	巴音郭楞	ruoqiang
轮台	bayinguoleng	巴音郭楞	luntai
吉木萨尔	changji	昌吉	jimusaer
呼图壁	changji	昌吉	hutubi
奇台	changji	昌吉	qitai
昌吉市	changji	昌吉	changji
木垒	changji	昌吉	mulei
玛纳斯	changji	昌吉	manasi
米泉	changji	昌吉	miquan
阜康	changji	昌吉	fukang
博乐	boertala	博尔塔拉	bole
温泉	boertala	博尔塔拉	wenquan
精河	boertala	博尔塔拉	jinghe
伊宁	yili	伊犁	yining
奎屯	yili	伊犁	kuitun
察布	yili	伊犁	chabu
尼勒克	yili	伊犁	nileke
巩留	yili	伊犁	gongliu
新源	yili	伊犁	xinyuan
昭苏	yili	伊犁	zhaosu
特克斯	yili	伊犁	tekesi
霍城	yili	伊犁	huocheng
乌苏	tacheng	塔城	wusu
和布克赛尔	tacheng	塔城	hebukesaier
塔城市	tacheng	塔城	tacheng
托里	tacheng	塔城	tuoli
沙湾	tacheng	塔城	shawan
裕民	tacheng	塔城	yumin
额敏	tacheng	塔城	emin
吉木乃	aletai	阿勒泰	jimunai
哈巴河	aletai	阿勒泰	habahe
富蕴	aletai	阿勒泰	fuyun
布尔津	aletai	阿勒泰	buerjin
福海	aletai	阿勒泰	fuhai
阿勒泰市	aletai	阿勒泰	aletai
青河	aletai	阿勒泰	qinghe
东城	shihezi	石河子	dongcheng
北泉	shihezi	石河子	beiquan
向阳	shihezi	石河子	xiangyang
新城	shihezi	石河子	xincheng
石河子乡	shihezi	石河子	shihezixiang
红山	shihezi	石河子	hongshan
老街	shihezi	石河子	laojie
城关	xz	拉萨	chengguan
堆龙德庆	xz	拉萨	duilongdeqing
墨竹工卡	xz	拉萨	mozhugongka
尼木	xz	拉萨	nimu
当雄	xz	拉萨	dangxiong
曲水	xz	拉萨	qushui
林周	xz	拉萨	linzhou
达孜	xz	拉萨	dazi
丁青	changdu	昌都	dingqing
八宿	changdu	昌都	baxiu
察雅	changdu	昌都	chaya
左贡	changdu	昌都	zuogong
昌都县	changdu	昌都	changduxian
江达	changdu	昌都	jiangda
洛隆	changdu	昌都	luolong
类乌齐	changdu	昌都	leiwuqi
芒康	changdu	昌都	mangkang
贡觉	changdu	昌都	gongjiao
边坝	changdu	昌都	bianba
乃东	shannan	山南	naidong
加查	shannan	山南	jiacha
扎囊	shannan	山南	zhanang
措美	shannan	山南	cuomei
曲松	shannan	山南	qusong
桑日	shannan	山南	sangri
洛扎	shannan	山南	luozha
浪卡子	shannan	山南	langkazi
琼结	shannan	山南	qiongjie
贡嘎	shannan	山南	gongga
错那	shannan	山南	cuona
隆子	shannan	山南	longzi
亚东	rikaze	日喀则	yadong
仁布	rikaze	日喀则	renbu
仲巴	rikaze	日喀则	zhongba
南木林	rikaze	日喀则	nanmulin
吉隆	rikaze	日喀则	jilong
定日	rikaze	日喀则	dingri
定结	rikaze	日喀则	dingjie
岗巴	rikaze	日喀则	gangba
康马	rikaze	日喀则	kangma
拉孜	rikaze	日喀则	lazi
日喀则市	rikaze	日喀则	rikazeshi
昂仁	rikaze	日喀则	angren
江孜	rikaze	日喀则	jiangzi
白朗	rikaze	日喀则	bailang
聂拉木	rikaze	日喀则	nielamu
萨嘎	rikaze	日喀则	saga
萨迦	rikaze	日喀则	sajia
谢通门	rikaze	日喀则	xietongmen
双湖	naqu	那曲	shuanghu
嘉黎	naqu	那曲	jiali
安多	naqu	那曲	anduo
尼玛	naqu	那曲	nima
巴青	naqu	那曲	baqing
比如	naqu	那曲	biru
班戈	naqu	那曲	bange
申扎	naqu	那曲	anzha
索县	naqu	那曲	suoxian
聂荣	naqu	那曲	nierong
那曲县	naqu	那曲	naquxian
噶尔	ali	阿里	gaer
措勤	ali	阿里	cuoqin
改则	ali	阿里	gaize
日土	ali	阿里	ritu
普兰	ali	阿里	pulan
札达	ali	阿里	zhada
革吉	ali	阿里	geji
墨脱	linzhi	林芝	motuo
察隅	linzhi	林芝	chayu
工布江达	linzhi	林芝	gongbujiangda
朗县	linzhi	林芝	langxian
林芝县	linzhi	林芝	linzhixian
波密	linzhi	林芝	bomi
米林	linzhi	林芝	milin
乐昌	shaoguan	韶关	lechang
乳源	shaoguan	韶关	ruyuan
仁化	shaoguan	韶关	renhua
南雄	shaoguan	韶关	nanxiong
始兴	shaoguan	韶关	shixing
新丰	shaoguan	韶关	xinfeng
曲江	shaoguan	韶关	qujiang
武江	shaoguan	韶关	wujiang
浈江	shaoguan	韶关	zhenjiang
翁源	shaoguan	韶关	wengyuan
吴川	zhanjiang	湛江	wuchuan
坡头	zhanjiang	湛江	potou
廉江	zhanjiang	湛江	lianjiang
开发区	zhanjiang	湛江	kaifaqu
徐闻	zhanjiang	湛江	xuwen
赤坎	zhanjiang	湛江	chikan
遂溪	zhanjiang	湛江	suixi
雷州	zhanjiang	湛江	leizhou
霞山	zhanjiang	湛江	xiashan
麻章	zhanjiang	湛江	mazhang
四会	zhaoqing	肇庆	sihui
封开	zhaoqing	肇庆	fengkai
广宁	zhaoqing	肇庆	guangning
德庆	zhaoqing	肇庆	deqing
怀集	zhaoqing	肇庆	huaiji
端州	zhaoqing	肇庆	duanzhou
高要	zhaoqing	肇庆	gaoyao
鼎湖	zhaoqing	肇庆	dinghu
丰顺	meizhou	梅州	fengshun
五华	meizhou	梅州	wuhua
兴宁	meizhou	梅州	xingning
大埔	meizhou	梅州	dapu
平远	meizhou	梅州	pingyuan
梅县	meizhou	梅州	meixian
梅江	meizhou	梅州	meijiang
蕉岭	meizhou	梅州	jiaoling
城区	shanwei	汕尾	chengqu
海丰	shanwei	汕尾	haifeng
陆丰	shanwei	汕尾	lufeng
陆河	shanwei	汕尾	luhe
东源	heyuan	河源	dongyuan
和平	heyuan	河源	heping
源城	heyuan	河源	yuancheng
紫金	heyuan	河源	zijin
连平	heyuan	河源	lianping
龙川	heyuan	河源	longchuan
江城	yangjiang	阳江	jiangcheng
阳东	yangjiang	阳江	yangdong
阳春	yangjiang	阳江	yangchun
阳西	yangjiang	阳江	yangxi
佛冈	qingyuan	清远	fogang
清城	qingyuan	清远	qingcheng
清新	qingyuan	清远	qingxin
英德	qingyuan	清远	yingde
连南	qingyuan	清远	liannan
连山	qingyuan	清远	lianshan
连州	qingyuan	清远	lianzhou
阳山	qingyuan	清远	yangshan
湘桥	chaozhou	潮州	xiangqiao
潮安	chaozhou	潮州	chaoan
饶平	chaozhou	潮州	raoping
惠来	jieyang	揭阳	huilai
揭东	jieyang	揭阳	jiedong
揭西	jieyang	揭阳	jiexi
普宁	jieyang	揭阳	puning
榕城	jieyang	揭阳	rongcheng
云城	yunfu	云浮	yuncheng
云安	yunfu	云浮	yunan
新兴	yunfu	云浮	xinxing
罗定	yunfu	云浮	luoding
郁南	yunfu	云浮	yvnan
东区	panzhihua	攀枝花	dongqu
仁和	panzhihua	攀枝花	renhe
盐边	panzhihua	攀枝花	yanbian
米易	panzhihua	攀枝花	miyi
西区	panzhihua	攀枝花	xiqu
元坝	guangyuan	广元	yuanba
剑阁	guangyuan	广元	jiange
市中	guangyuan	广元	shizhong
旺苍	guangyuan	广元	wangcang
朝天	guangyuan	广元	chaotian
苍溪	guangyuan	广元	cangxi
青川	guangyuan	广元	qingchuan
大英	suining	遂宁	daying
安居	suining	遂宁	anju
射洪	suining	遂宁	shehong
船山	suining	遂宁	chuanshan
蓬溪	suining	遂宁	pengxi
东兴	neijiang	内江	dongxing
威远	neijiang	内江	weiyuan
市中	neijiang	内江	shizhong
资中	neijiang	内江	zizhong
隆昌	neijiang	内江	longchang
华蓥	guangan	广安	huaying
岳池	guangan	广安	yuechi
广安区	guangan	广安	guangan
广安城北	guangan	广安	guanganchengbei
广安城南	guangan	广安	guanganchengnan
武胜	guangan	广安	wusheng
邻水	guangan	广安	linshui
东坡	meishan	眉山	dongpo
丹棱	meishan	眉山	danleng
仁寿	meishan	眉山	renshou
彭山	meishan	眉山	pengshan
洪雅	meishan	眉山	hongya
青神	meishan	眉山	qingshen
名山	yaan	雅安	mingshan
天全	yaan	雅安	tianquan
宝兴	yaan	雅安	baoxing
汉源	yaan	雅安	hanyuan
石棉	yaan	雅安	shimian
芦山	yaan	雅安	lushan
荥经	yaan	雅安	yingjing
雨城	yaan	雅安	yucheng
南江	bazhong	巴中	nanjiang
巴州	bazhong	巴中	bazhou
平昌	bazhong	巴中	pingchang
通江	bazhong	巴中	tongjiang
乐至	ziyang	资阳	lezhi
安岳	ziyang	资阳	anyue
简阳	ziyang	资阳	jianyang
雁江	ziyang	资阳	yanjiang
九寨沟	aba	阿坝	jiuzhaigou
壤塘	aba	阿坝	rangtang
小金	aba	阿坝	xiaojin
松潘	aba	阿坝	songpan
汶川	aba	阿坝	wenchuan
理县	aba	阿坝	lixian
红原	aba	阿坝	hongyuan
若尔盖	aba	阿坝	ruoergai
茂县	aba	阿坝	maoxian
金川	aba	阿坝	jinchuan
阿坝县	aba	阿坝	aba
马尔康	aba	阿坝	maerkang
黑水	aba	阿坝	heishui
丹巴	ganzi	甘孜	danba
九龙	ganzi	甘孜	jiulong
乡城	ganzi	甘孜	xiangcheng
巴塘	ganzi	甘孜	batang
康定	ganzi	甘孜	kangding
得荣	ganzi	甘孜	derong
德格	ganzi	甘孜	dege
新龙	ganzi	甘孜	xinlong
泸定	ganzi	甘孜	luding
炉霍	ganzi	甘孜	luhuo
理塘	ganzi	甘孜	litang
甘孜县	ganzi	甘孜	ganzi
白玉	ganzi	甘孜	baiyu
石渠	ganzi	甘孜	shiqu
稻城	ganzi	甘孜	daocheng
色达	ganzi	甘孜	seda
道孚	ganzi	甘孜	daofu
雅江	ganzi	甘孜	yajiang
云和	lishui	丽水	yunhe
庆元	lishui	丽水	qingyuan
景宁	lishui	丽水	jingning
松阳	lishui	丽水	songyang
缙云	lishui	丽水	jinyun
莲都	lishui	丽水	liandu
遂昌	lishui	丽水	suichang
青田	lishui	丽水	pingtian
龙泉	lishui	丽水	longquan
南芬	benxi	本溪	nanfen
平山	benxi	本溪	pingshan
明山	benxi	本溪	mingshan
本溪县	benxi	本溪	benxi
桓仁	benxi	本溪	huanren
溪湖	benxi	本溪	xihu
太平	fuxin	阜新	taiping
彰武	fuxin	阜新	zhangwu
新邱	fuxin	阜新	xinqiu
海州	fuxin	阜新	haizhou
清河门	fuxin	阜新	qinghemen
细河	fuxin	阜新	xihe
阜新县	fuxin	阜新	fuxin
开原	tieling	铁岭	kaiyuan
昌图	tieling	铁岭	changtu
清河	tieling	铁岭	qinghe
西丰	tieling	铁岭	xifeng
调兵山	tieling	铁岭	diaobingshan
铁岭县	tieling	铁岭	tieling
银州	tieling	铁岭	yinzhou
凌源	chaoyang	朝阳市	lingyuan
北票	chaoyang	朝阳市	beipiao
双塔	chaoyang	朝阳市	shuangta
喀喇沁左翼	chaoyang	朝阳市	kalaqinzuoyi
建平	chaoyang	朝阳市	jianping
朝阳县	chaoyang	朝阳市	chaoyang
龙城	chaoyang	朝阳市	longcheng
丹徒	zhenjiang	镇江	dantu
丹阳	zhenjiang	镇江	danyang
京口	zhenjiang	镇江	jingkou
句容	zhenjiang	镇江	jurong
扬中	zhenjiang	镇江	yangzhong
润州	zhenjiang	镇江	runzhou
镇江新区	zhenjiang	镇江	zhenjiangxinqu
兴化	jstaizhou	泰州	xinghua
姜堰	jstaizhou	泰州	jiangyan
泰兴	jstaizhou	泰州	taixing
海陵	jstaizhou	泰州	hailing
靖江	jstaizhou	泰州	jingjiang
高港	jstaizhou	泰州	gaogang
宿城区	suqian	宿迁	suchengqu
宿豫	suqian	宿迁	suyu
沭阳	suqian	宿迁	shuyang
泗洪	suqian	宿迁	sihong
泗阳	suqian	宿迁	siyang
兰考	kaifeng	开封	lankao
尉氏	kaifeng	开封	weishi
开封县	kaifeng	开封	kaifeng
杞县	kaifeng	开封	qixian
禹王台	kaifeng	开封	yuwangtai
通许	kaifeng	开封	tongxu
金明	kaifeng	开封	jinming
顺河	kaifeng	开封	shunhe
鼓楼	kaifeng	开封	gulou
龙亭	kaifeng	开封	longting
华龙	puyang	濮阳	hualong
南乐	puyang	濮阳	nanle
台前	puyang	濮阳	taiqian
清丰	puyang	濮阳	qingfeng
濮阳县	puyang	濮阳	puyang
范县	puyang	濮阳	fanxian
高新	puyang	濮阳	gaoxin
禹州	xuchang	许昌	yuzhou
襄城	xuchang	许昌	xiangcheng
许昌县	xuchang	许昌	xuchang
鄢陵	xuchang	许昌	yanling
长葛	xuchang	许昌	zhangge
魏都	xuchang	许昌	weidou
义马	sanmenxia	三门峡	yima
卢氏	sanmenxia	三门峡	lushi
渑池	sanmenxia	三门峡	mianchi
湖滨	sanmenxia	三门峡	hubin
灵宝	sanmenxia	三门峡	lingbao
陕县	sanmenxia	三门峡	shanxian
夏邑	shangqiu	商丘	xiayi
宁陵	shangqiu	商丘	ningling
柘城	shangqiu	商丘	zhecheng
梁园	shangqiu	商丘	liangyuan
民权	shangqiu	商丘	minquan
永城	shangqiu	商丘	yongcheng
睢县	shangqiu	商丘	suixian
睢阳	shangqiu	商丘	suiyang
虞城	shangqiu	商丘	yucheng
光山	xinyang	信阳	guangshan
商城	xinyang	信阳	shangcheng
固始	xinyang	信阳	gushi
平桥	xinyang	信阳	pingqiao
息县	xinyang	信阳	xixian
新县	xinyang	信阳	xinxian
负	xinyang	信阳	shihe
淮滨	xinyang	信阳	huaibin
潢川	xinyang	信阳	huangchuan
罗山	xinyang	信阳	luoshan
商水	zhoukou	周口	shangshui
太康	zhoukou	周口	taikang
川汇	zhoukou	周口	chuanhui
扶沟	zhoukou	周口	fugou
沈丘	zhoukou	周口	shenqiu
淮阳	zhoukou	周口	huaiyang
西华	zhoukou	周口	xihua
郸城	zhoukou	周口	dancheng
项城	zhoukou	周口	xiangcheng
鹿邑	zhoukou	周口	luyi
上蔡	zhumadian	驻马店	shangcai
平舆	zhumadian	驻马店	pingyu
新蔡	zhumadian	驻马店	xincai
正阳	zhumadian	驻马店	zhengyang
汝南	zhumadian	驻马店	runan
泌阳	zhumadian	驻马店	miyang
确山	zhumadian	驻马店	queshan
西平	zhumadian	驻马店	xiping
遂平	zhumadian	驻马店	suiping
驿城	zhumadian	驻马店	yicheng
勃利	qitaihe	七台河	boli
新兴	qitaihe	七台河	xinxing
桃山	qitaihe	七台河	taoshan
茄子河	qitaihe	七台河	qiezihe
东宁	mudanjiang	牡丹江	dongning
东安	mudanjiang	牡丹江	dongan
宁安	mudanjiang	牡丹江	ningan
林口	mudanjiang	牡丹江	linkou
海林	mudanjiang	牡丹江	hailin
爱民	mudanjiang	牡丹江	aimin
穆棱	mudanjiang	牡丹江	muleng
绥芬河	mudanjiang	牡丹江	suifenhe
西安	mudanjiang	牡丹江	xian
阳明	mudanjiang	牡丹江	yangming
加格达奇	daxinganling	大兴安岭	jiagedaqi
呼中	daxinganling	大兴安岭	huzhong
呼玛	daxinganling	大兴安岭	huma
塔河	daxinganling	大兴安岭	tahe
新林	daxinganling	大兴安岭	xinlin
松岭	daxinganling	大兴安岭	songling
漠河	daxinganling	大兴安岭	mohe
任城	jining	济宁	rencheng
兖州	jining	济宁	yanzhou
嘉祥	jining	济宁	jiaxiang
市中	jining	济宁	shizhong
微山	jining	济宁	weishan
曲阜	jining	济宁	qufu
梁山	jining	济宁	liangshan
汶上	jining	济宁	wenshang
泗水	jining	济宁	sishui
邹城	jining	济宁	zoucheng
金乡	jining	济宁	jinxiang
鱼台	jining	济宁	yutai
东平	taian	泰安	dongping
宁阳	taian	泰安	ningyang
岱岳	taian	泰安	daiyue
新泰	taian	泰安	xintai
泰山	taian	泰安	taishan
肥城	taian	泰安	feicheng
东港	rizhao	日照	donggang
五莲	rizhao	日照	wulian
岚山	rizhao	日照	lanshan
莒县	rizhao	日照	juxian
临沭	linyi	临沂	linshu
临港	linyi	临沂	lingangqu
兰山	linyi	临沂	lanshan
北城新区	linyi	临沂	beichengxinqu
平邑	linyi	临沂	pingyi
开发区	linyi	临沂	kaifaqu
沂南	linyi	临沂	yinan
沂水	linyi	临沂	yishui
河东	linyi	临沂	hedong
罗庄	linyi	临沂	luozhuang
苍山	linyi	临沂	cangshan
莒南	linyi	临沂	junan
蒙阴	linyi	临沂	mengyin
费县	linyi	临沂	feixian
郯城	linyi	临沂	tancheng
高新区	linyi	临沂	gaoxinqu
临邑	dezhou	德州	linyi
乐陵	dezhou	德州	leling
夏津	dezhou	德州	xiajin
宁津	dezhou	德州	ningjin
平原	dezhou	德州	pingyuan
庆云	dezhou	德州	qingyun
德城	dezhou	德州	decheng
武城	dezhou	德州	wucheng
禹城	dezhou	德州	yucheng
陵县	dezhou	德州	lingxian
齐河	dezhou	德州	qihe
东昌府	liaocheng	聊城	dongchangfu
东阿	liaocheng	聊城	donga
临清	liaocheng	聊城	linqing
冠县	liaocheng	聊城	guanxian
茌平	liaocheng	聊城	chiping
莘县	liaocheng	聊城	shenxian
阳谷	liaocheng	聊城	yanggu
高唐	liaocheng	聊城	gaotang
八公山	huainan	淮南	bagongshan
凤台	huainan	淮南	fengtai
大通	huainan	淮南	datong
潘集	huainan	淮南	panji
田家庵	huainan	淮南	tianjiaan
谢家集	huainan	淮南	xiejiaji
杜集	huaibei	淮北	duji
濉溪	huaibei	淮北	suixi
烈山	huaibei	淮北	lieshan
相山	huaibei	淮北	xiangshan
狮子山	tongling	铜陵	shizishan
郊区	tongling	铜陵	jiao
铜官山	tongling	铜陵	tongguanshan
铜陵县	tongling	铜陵	tonglingxian
休宁	huangshan	黄山	xiuning
屯溪	huangshan	黄山	tunxi
徽州	huangshan	黄山	huizhou
歙县	huangshan	黄山	xixian
祁门	huangshan	黄山	qimen
黄山区	huangshan	黄山	huangshan
黟县	huangshan	黄山	yixian
利辛	bozhou	亳州	lixin
涡阳	bozhou	亳州	woyang
蒙城	bozhou	亳州	mengcheng
谯城	bozhou	亳州	qiaocheng
东至	chizhou	池州	dongzhi
石台	chizhou	池州	shitai
贵池	chizhou	池州	guichi
青阳	chizhou	池州	qingyang
宁国	xuancheng	宣城	ningguo
宣州	xuancheng	宣城	xuanzhou
广德	xuancheng	宣城	guangde
旌德	xuancheng	宣城	jingde
泾县	xuancheng	宣城	jingxian
绩溪	xuancheng	宣城	jixi
郎溪	xuancheng	宣城	langxi
合浦	beihai	北海	hepu
海城	beihai	北海	haicheng
铁山港	beihai	北海	tieshangang
银海	beihai	北海	yinhai
上思	fangchenggang	防城港	shangsi
东兴	fangchenggang	防城港	dongxing
港口	fangchenggang	防城港	gangkou
防城	fangchenggang	防城港	fangcheng
八步	hezhou	贺州	babu
富川	hezhou	贺州	fuchuan
昭平	hezhou	贺州	zhaoping
钟山	hezhou	贺州	zhongshan
凭祥	chongzuo	崇左	pingxiang
大新	chongzuo	崇左	daxin
天等	chongzuo	崇左	tiandeng
宁明	chongzuo	崇左	ningming
扶绥	chongzuo	崇左	fusui
江州	chongzuo	崇左	jiangzhou
龙州	chongzuo	崇左	longzhou
东乌珠穆沁	xilinguole	锡林郭勒	dongwuzhumuqin
二连浩特	xilinguole	锡林郭勒	erlianhaote
多伦	xilinguole	锡林郭勒	duolun
太仆寺	xilinguole	锡林郭勒	taipusi
正蓝	xilinguole	锡林郭勒	zhenglan
正镶白	xilinguole	锡林郭勒	zhengxiangbai
苏尼特右	xilinguole	锡林郭勒	suniteyou
苏尼特左	xilinguole	锡林郭勒	sunitezuo
西乌珠穆沁	xilinguole	锡林郭勒	xiwuzhumuqin
锡林浩特	xilinguole	锡林郭勒	xilinhaote
镶黄	xilinguole	锡林郭勒	xianghuang
阿巴嘎	xilinguole	锡林郭勒	abaga
阿拉善右	alashan	阿拉善	alashanyou
阿拉善左	alashan	阿拉善	alashanzuo
额济纳	alashan	阿拉善	ejina
中阳	lvliang	吕梁	zhongyang
临县	lvliang	吕梁	linxian
交口	lvliang	吕梁	jiaokou
交城	lvliang	吕梁	jiaocheng
兴县	lvliang	吕梁	xingxian
孝义	lvliang	吕梁	xiaoyi
岚县	lvliang	吕梁	lanxian
文水	lvliang	吕梁	wenshui
方山	lvliang	吕梁	fangshan
柳林	lvliang	吕梁	liulin
汾阳	lvliang	吕梁	fenyang
石楼	lvliang	吕梁	shilou
离石	lvliang	吕梁	lishi
两当	longnan	陇南	liangdang
宕昌	longnan	陇南	dangchang
康县	longnan	陇南	kangxian
徽县	longnan	陇南	huixian
成县	longnan	陇南	chengxian
文县	longnan	陇南	wenxian
武都	longnan	陇南	wudou
礼县	longnan	陇南	lixian
西和	longnan	陇南	xihe
东乡	linxia	临夏	dongxiang
临夏市	linxia	临夏	linxia
和政	linxia	临夏	hezheng
广河	linxia	临夏	guanghe
康乐	linxia	临夏	kangle
永靖	linxia	临夏	yongjing
积石山	linxia	临夏	jishishan
临潭	gannan	甘南	lintan
卓尼	gannan	甘南	zhuoni
合作	gannan	甘南	hezuo
夏河	gannan	甘南	xiahe
玛曲	gannan	甘南	maqu
碌曲	gannan	甘南	luqu
舟曲	gannan	甘南	zhouqu
迭部	gannan	甘南	diebu
云梦	xiaogan	孝感	yunmeng
大悟	xiaogan	孝感	dawu
孝南	xiaogan	孝感	xiaonan
孝昌	xiaogan	孝感	xiaochang
安陆	xiaogan	孝感	anlu
应城	xiaogan	孝感	yingcheng
汉川	xiaogan	孝感	hanchuan
团风	huanggang	黄冈	tuanfeng
武穴	huanggang	黄冈	wuxue
浠水	huanggang	黄冈	xishui
红安	huanggang	黄冈	hongan
罗田	huanggang	黄冈	luotian
英山	huanggang	黄冈	yingshan
蕲春	huanggang	黄冈	qichun
麻城	huanggang	黄冈	macheng
黄州	huanggang	黄冈	huangzhou
黄梅	huanggang	黄冈	huangmei
咸安	xianning	咸宁	xianan
嘉鱼	xianning	咸宁	jiayu
崇阳	xianning	咸宁	chongyang
赤壁	xianning	咸宁	chibi
通城	xianning	咸宁	tongcheng
通山	xianning	咸宁	tongshan
广水	suizhou	随州	guangshui
曾都	suizhou	随州	cengdou
利川	enshi	恩施	lichuan
咸丰	enshi	恩施	xianfeng
宣恩	enshi	恩施	xuanen
巴东	enshi	恩施	badong
建始	enshi	恩施	jianshi
恩施市	enshi	恩施	enshi
来凤	enshi	恩施	laifeng
鹤峰	enshi	恩施	hefeng
九真	tianmen	天门	jiuzhen
佛子山	tianmen	天门	fozishan
候口	tianmen	天门	houkou
净潭	tianmen	天门	jingtan
卢市	tianmen	天门	lushi
多宝	tianmen	天门	duobao
多祥	tianmen	天门	duoxiang
小板	tianmen	天门	xiaoban
岳口	tianmen	天门	lekou
干驿	tianmen	天门	qianyi
张港	tianmen	天门	zhanggang
彭市	tianmen	天门	pengshi
拖市	tianmen	天门	tuoshi
杨林	tianmen	天门	yanglin
横林	tianmen	天门	henglin
汪场	tianmen	天门	wangchang
渔薪	tianmen	天门	yuxin
皂市	tianmen	天门	zaoshi
石河	tianmen	天门	shihe
竟陵	tianmen	天门	jingling
胡市	tianmen	天门	hushi
蒋场	tianmen	天门	jiangchang
马湾	tianmen	天门	mawan
麻洋	tianmen	天门	mayang
黄潭	tianmen	天门	huangtan
下谷平	shennongjia	神农架	xiaguoping
九湖	shennongjia	神农架	jiuhu
宋洛	shennongjia	神农架	songluo
新华	shennongjia	神农架	xinhua
木鱼	shennongjia	神农架	muyu
松柏	shennongjia	神农架	songbai
红坪	shennongjia	神农架	hongping
阳日	shennongjia	神农架	yangri
慈利	zhangjiajie	张家界	cili
桑植	zhangjiajie	张家界	sangzhi
武陵源	zhangjiajie	张家界	wulingyuan
永定	zhangjiajie	张家界	yongding
南县	yiyang	益阳	nanxian
安化	yiyang	益阳	anhua
桃江	yiyang	益阳	taojiang
沅江	yiyang	益阳	yuanjiang
资阳	yiyang	益阳	ziyang
赫山	yiyang	益阳	heshan
中方	huaihua	怀化	zhongfang
会同	huaihua	怀化	huitong
新晃	huaihua	怀化	xinhuang
沅陵	huaihua	怀化	yuanling
洪江	huaihua	怀化	hongjiang
溆浦	huaihua	怀化	xupu
芷江	huaihua	怀化	zhijiang
辰溪	huaihua	怀化	chenxi
通道	huaihua	怀化	tongdao
靖州	huaihua	怀化	jingzhou
鹤城	huaihua	怀化	hecheng
麻阳	huaihua	怀化	mayang
保靖	xiangxi	湘西	baojing
凤凰	xiangxi	湘西	fenghuang
古丈	xiangxi	湘西	guzhang
吉首	xiangxi	湘西	jishou
永顺	xiangxi	湘西	yongshun
泸溪	xiangxi	湘西	luxi
花垣	xiangxi	湘西	huayuan
龙山	xiangxi	湘西	longshan
东明	heze	菏泽	dongming
单县	heze	菏泽	danxian
定陶	heze	菏泽	dingtao
巨野	heze	菏泽	juye
成武	heze	菏泽	chengwu
曹县	heze	菏泽	caoxian
牡丹	heze	菏泽	mudan
郓城	heze	菏泽	yuncheng
鄄城	heze	菏泽	juancheng
大武口	shizuishan	石嘴山	dawukou
平罗	shizuishan	石嘴山	luoping
惠农	shizuishan	石嘴山	huinong
利通	wuzhong	吴忠	litong
同心	wuzhong	吴忠	tongxin
盐池	wuzhong	吴忠	yanchi
青铜峡	wuzhong	吴忠	qingtongxia
原州	guyuan	固原	yuanzhou
彭阳	guyuan	固原	pengyang
泾源	guyuan	固原	jingyuan
西吉	guyuan	固原	xiji
隆德	guyuan	固原	longde
中宁	zhongwei	中卫	zhongning
沙坡头	zhongwei	中卫	shapotou
海原	zhongwei	中卫	haiyuan
镜铁区	jiayuguan	嘉峪关	jingtie
长城区	jiayuguan	嘉峪关	changcheng
雄关区	jiayuguan	嘉峪关	xiongguan
东区	xianggang	香港	dongqu
中西区	xianggang	香港	zhongxi
九龙城区	xianggang	香港	jiulong
元朗区	xianggang	香港	yuanlang
北区	xianggang	香港	beiqu
南区	xianggang	香港	nanqu
大埔区	xianggang	香港	dapu
屯门区	xianggang	香港	tuimen
沙田区	xianggang	香港	shatian
油尖旺区	xianggang	香港	youjianwang
深水肚	xianggang	香港	shengshuibu
湾仔区	xianggang	香港	wanzai
离岛区	xianggang	香港	lidao
荃湾区	xianggang	香港	quanwan
葵青区	xianggang	香港	kuiqing
西贡区	xianggang	香港	xigong
观塘区	xianggang	香港	guangtang
黄大仙区	xianggang	香港	huangdaxian
其他堂区	aomen	澳门	qitatang
嘉模堂	aomen	澳门	jiamotang
圣安多尼堂	aomen	澳门	shenganduonitang
圣方济各堂	aomen	澳门	shengfangjigetang
大堂	aomen	澳门	datang
望德堂	aomen	澳门	wangdetang
花地玛堂	aomen	澳门	huadimatang
风顺堂	aomen	澳门	fengshuntang
五指山周边	wuzhishan	五指山	wuzhishanzhoubian
冲山镇	wuzhishan	五指山	chongshanzhen
南圣镇	wuzhishan	五指山	nanshengzhen
毛阳镇	wuzhishan	五指山	maoyangzhen
番阳镇	wuzhishan	五指山	fanyangzhen
且末	kuerle	库尔勒	qiemo
博湖	kuerle	库尔勒	bohu
和硕	kuerle	库尔勒	heshuo
和静	kuerle	库尔勒	hejing
尉犁	kuerle	库尔勒	weili
库尔勒周边	kuerle	库尔勒	kuerlezhoubian
焉耆	kuerle	库尔勒	yanqi
若羌	kuerle	库尔勒	ruoqiang
轮台	kuerle	库尔勒	luntai
南口街道	alaer	阿拉尔	nankoujiedao
团场	alaer	阿拉尔	tuanchang
幸福路街道	alaer	阿拉尔	xingfulujiedao
金银川路街道	alaer	阿拉尔	jinyinchuanlujiedao
阿拉尔周边	alaer	阿拉尔	alaerzhoubian
青松路街道	alaer	阿拉尔	qingsonglujiedao
其盖麦旦	tumushuke	图木舒克	qigaimaidan
喀拉拜勒镇	tumushuke	图木舒克	kalabailezhen
图木休克	tumushuke	图木舒克	tumuxiuke
图木舒克周边	tumushuke	图木舒克	tumushukezhoubian
图木舒克市区	tumushuke	图木舒克	tumushukeshiqu
永安坝	tumushuke	图木舒克	yonganba
皮恰克松地	tumushuke	图木舒克	piqiakesongdi
盖米里克	tumushuke	图木舒克	gaimilike
金墩	tumushuke	图木舒克	jindun
101团	wujiaqu	五家渠	101tuan
102团	wujiaqu	五家渠	102tuan
103团	wujiaqu	五家渠	103tuan
五家渠周边	wujiaqu	五家渠	wujiaquzhoubian
人民路街道	wujiaqu	五家渠	renminlujiedao
军垦路街道	wujiaqu	五家渠	junkenlujiedao
青湖路街道	wujiaqu	五家渠	qinghulujiedao
